psychotherapy	paɪʧoʊθəreɪpaɪ	<ˌsaɪkoʊˈθɛrəpi>
inlay	ɪnleɪ	<ˈɪnˌleɪ>
unstructured	ənstrəktʊrd	<ənˈstrəkʃərd>
hyperactive	haɪpəræktaɪv	<ˌhaɪpərˈæktɪv>
worker	wərkər	<ˈwərkər>
qualitative	kwɑlaɪtɑtaɪv	<kˈwɑləˌteɪtɪv>
beep	bip	<bip>
quarrying	kwɑrraɪɪŋ	<kˈwɔriɪŋ>
rabid	ræbɪd	<ˈræbɪd>
flammable	flæmmɑbli	<ˈflæməbəl>
throes	θroʊz	<θroʊz>
occupy	ɑkkupaɪ	<ˈɑkjəˌpaɪ>
gent	ʤɛnt	<ʤɛnt>
hepatic	hipætɪk	<həˈpætɪk>
hypertrophy	haɪpərtroʊfaɪ	<ˈhaɪpərˌtroʊfi>
destruction	distrəktaɪn	<dɪˈstrəkʃən>
parlour	pɑrlaʊər	<ˈpɑrlər>
lichen	laɪʧɛn	<ˈlaɪkən>
lupus	lupʊz	<ˈlupəs>
blindfold	blɪndfoʊld	<ˈblaɪndˌfoʊld>
preservative	prisərveɪtaɪv	<priˈzərvətɪv>
hesitation	hɛsaɪtɑtaɪn	<ˌhɛzəˈteɪʃən>
unwilling	ənwɪlɪŋ	<ənˈwɪlɪŋ>
tuba	tubɑ	<ˈtubə>
are	ɛr	<ər>
grouse	graʊs	<graʊs>
muller	mələr	<ˈmələr>
surrealism	sərriælɪs	<sərˈiəˌlɪzəm>
salmonella	sælmoʊnɛllɑ	<ˌsælməˈnɛlə>
faithfulness	feɪθfəlnɛs	<ˈfeɪθfəlˌnɛs>
depleted	diplɛtɛd	<dɪˈplitɪd>
bender	bɛndər	<ˈbɛndər>
sew	su	<soʊ>
residing	risɪdɪŋ	<rɪˈzaɪdɪŋ>
slick	slɪk	<slɪk>
rage	reɪʤ	<reɪʤ>
disposition	dɪspoʊsitaɪn	<ˌdɪspəˈzɪʃən>
orphan	ərfæn	<ˈɔrfən>
ash	æʃ	<æʃ>
exhaustion	ɛkshaʊztaɪn	<ɪgˈzɔsʧən>
lodge	lɑʤ	<lɑʤ>
impeding	ɪmpɛdɪŋ	<ˌɪmˈpidɪŋ>
augmented	ɔgmɛntɛd	<ɑgˈmɛntəd>
marketplace	mɑrkɛtpleɪs	<ˈmɑrkɪtˌpleɪs>
optimist	ɑptimɪst	<ˈɑptɪmɪst>
chew	ʧu	<ʧu>
cobwebs	kɑbwɛbz	<ˈkɑbˌwɛbz>
microgram	mikroʊgræm	<ˈmaɪkroʊˌgræm>
ova	oʊvɑ	<ˈoʊvə>
peacetime	pistaɪm	<ˈpiˌstaɪm>
fall	fæl	<fɔl>
doctrine	dɑktraɪn	<ˈdɔktərɪn>
depart	dipɑrt	<dɪˈpɑrt>
angler	ænglər	<ˈæŋglər>
geography	ʤiɑgrɑfaɪ	<ʤiˈɑgrəfi>
phi	faɪ	<faɪ>
goldfish	goʊldfɪʃ	<ˈgoʊldˌfɪʃ>
concatenation	kɑnkætinɑtaɪn	<kənˌkætəˈneɪʃən>
sovereign	sɑvərɪŋ	<ˈsɑvrən>
hale	heɪl	<heɪl>
dairies	dɛraɪz	<ˈdɛriz>
unable	əneɪbli	<əˈneɪbəl>
alias	elaɪz	<ˈeɪliəs>
destructive	distrəktaɪv	<dɪˈstrəktɪv>
parlor	pɑrlɔr	<ˈpɑrlər>
unofficial	ənɑffaɪkil	<ˌənəˈfɪʃəl>
adapter	eɪdæptər	<əˈdæptər>
minder	mɪndər	<ˈmaɪndər>
face	feɪs	<feɪs>
peruse	piruz	<pəruz>
endoscopy	ɛndɑskoʊpaɪ	<ˌɛnˈdɔskɑpi>
hang	hæŋ	<hæŋ>
german	gərmæn	<ˈʤərmən>
irrational	ərrɑtaɪnæl	<ˌɪˈræʃənəl>
hostage	hɑsteɪʤ	<ˈhɑstɪʤ>
acoustical	eɪkaʊztikæl	<əˈkustɪkəl>
oppressive	ɑpprɛzsaɪv	<əˈprɛsɪv>
bauxite	bɑksaɪt	<ˈbɔksaɪt>
squatting	skwɑttɪŋ	<skˈwɑtɪŋ>
flavor	flɑvɔr	<ˈfleɪvər>
overlay	oʊvərleɪ	<ˈoʊvərˌleɪ>
mutated	mutætɛd	<mˈjuˌteɪtɪd>
accrue	ækkru	<əˈkru>
paraffin	pɑræffɪn	<ˈpɛrəfən>
ephedrine	ifɛdraɪn	<ɪˈfɛdrɪn>
correspondingly	kɔrrispɑndɪŋlaɪ	<ˌkɔrəˈspɑndɪŋli>
outgrowth	aʊtgroʊθ	<ˈaʊtˌgroʊθ>
pumice	pəmaɪs	<ˈpəməs>
hacienda	hækaɪɛndɑ	<ˌhæsiˈɛndə>
heartbreaking	hɑrtbrikɪŋ	<ˈhɑrtˌbreɪkɪŋ>
podium	poʊdaɪəm	<ˈpoʊdiəm>
upholding	əphoʊldɪŋ	<əˈphoʊldɪŋ>
withstand	wɪθstænd	<wɪθˈstænd>
dismissal	dɪsmɪsæl	<dɪsˈmɪsəl>
fussy	fəsjaɪ	<ˈfəsi>
telecommunications	tɛlikɑmmunikɑtaɪnz	<ˌtɛləkəmˌjunəˈkeɪʃənz>
guile	gaɪl	<gaɪl>
noon	nun	<nun>
afloat	eɪfloʊt	<əˈfloʊt>
prohibit	proʊhɪbɪt	<proʊˈhɪbət>
fusion	fusɪn	<fˈjuʒən>
org	ɔrg	<ɔrg>
scribe	skraɪb	<skraɪb>
barrow	bɑrroʊ	<ˈbɛroʊ>
substance	səbstæns	<ˈsəbstəns>
counterclockwise	kaʊntərklɑkwaɪz	<ˌkaʊnərˈklɔkwaɪz>
propellant	proʊpɛllænt	<prəˈpɛlənt>
consolation	kɑnsoʊlɑtaɪn	<ˌkɑnsəˈleɪʃən>
respective	rispɛktaɪv	<rɪˈspɛktɪv>
must	məst	<məst>
wept	wɛpt	<wɛpt>
glamorous	glæməraʊz	<ˈglæmərəs>
chin	ʧɪn	<ʧɪn>
finalized	faɪnɑlaɪzd	<ˈfaɪnəˌlaɪzd>
biff	bɪf	<bɪf>
knitter	nɪttər	<ˈnɪtər>
canister	kænɪstər	<ˈkænɪstər>
fasten	fæstɛn	<ˈfæsən>
guacamole	goʊkɑmoʊli	<gˌwɑkəˈmoʊli>
centrifugal	sɛntrɪfugæl	<ˈsɛntrɪfˌjugəl>
sleeveless	slivlɛs	<sˈlivlɪs>
divestiture	daɪvɛstaɪtʊr	<dɪˈvɛstɪʧər>
infallible	ɪnfællaɪbli	<ˌɪnˈfæləbəl>
allege	ælliʤ	<əˈlɛʤ>
ability	eɪbɪlaɪtaɪ	<əˈbɪləˌti>
fiberglass	faɪbərglæs	<ˈfaɪbərˌglæs>
cheaply	ʧiplaɪ	<ˈʧipli>
hysterical	hɪstəraɪkæl	<hɪˈstɛrɪkəl>
tent	tɛnt	<tɛnt>
productively	proʊdəktaɪvlaɪ	<pərˈdəktɪvli>
elegantly	ɛligæntlaɪ	<ˈɛlɪgənˌtli>
brother	broʊθər	<ˈbrəðər>
confiscation	kɑnfɪskɑtaɪn	<ˌkɑnfəˈskeɪʃən>
maxima	mæksaɪmɑ	<ˈmæksəmə>
feline	filaɪn	<ˈfiˌlaɪn>
beneficially	bɛnifaɪkillaɪ	<ˌbɛnəˈfɪʃəli>
elevated	ɛlivætɛd	<ˈɛləˌveɪtɪd>
reflective	riflɛktaɪv	<rɪˈflɛktɪv>
unveiling	ənvilɪŋ	<ənˈveɪlɪŋ>
staying	steɪɪŋ	<steɪɪŋ>
philanthropist	faɪlænθroʊpɪst	<fɪˈlænθrəpɪst>
ask	æsk	<æsk>
indicating	ɪndaɪkætɪŋ	<ˈɪndəˌkeɪtɪŋ>
went	wɛnt	<wɛnt>
cystic	kɪstɪk	<ˈsɪstɪk>
jury	ʤuraɪ	<ˈʤʊri>
stock	stɑk	<stɑk>
memory	mɛmoʊraɪ	<ˈmɛməri>
buzz	bəz	<bəz>
bureaus	buriz	<ˈbjʊroʊz>
cemetery	sɛmitərjaɪ	<ˈsɛmɪˌtɛri>
exchequer	ɛksʧɛkjʊr	<ˈɛksˌʧɛkər>
aggregation	æggrigɑtaɪn	<ˌægrəˈgeɪʃən>
photocopier	foʊtoʊkɑpaɪər	<ˈfoʊtoʊˌkɑpiər>
active	æktaɪv	<ˈæktɪv>
decreasing	dikrizɪŋ	<ˈdiˌkrisɪŋ>
dainty	deɪntaɪ	<ˈdeɪnti>
rainforest	reɪnfɔrɛst	<ˈraɪnˌfɔrəst>
episcopal	ipɪskoʊpæl	<ɪˈpɪskəpəl>
superlative	supərlɑtaɪv	<sʊˈpərlətɪv>
policyholder	pɑlaɪkaɪhoʊldər	<ˈpɑləsiˌhoʊldər>
trample	træmpli	<ˈtræmpəl>
uncomfortable	ənkɑmfɔrteɪbli	<ənˈkəmfərtəbəl>
deceptively	disɛptaɪvlaɪ	<dɪˈsɛptɪvli>
waterman	wɑtərmæn	<ˈwɔtərmən>
undertaking	əndərtækɪŋ	<ˈəndərˌteɪkɪŋ>
cirrus	kɪrrəs	<ˈsɪrəs>
voluminous	voʊluminuz	<vəˈlumənəs>
stupid	stupɪd	<ˈstupɪd>
huge	hju	<juʤ>
golfer	gɔfər	<ˈgɑlfər>
splitter	spɪttər	<ˈsplɪtər>
prudential	prudɛntil	<pruˈdɛnʃəl>
discrepancy	dɪskrɛpænkaɪ	<dɪˈskrɛpənsi>
peeler	pilər	<ˈpilər>
cate	keɪt	<keɪt>
handgun	hændgən	<ˈhændˌgən>
parallelism	pɑrællɛlɪs	<ˈpɛrəˌlɛˌlɪzəm>
pains	peɪnz	<peɪnz>
reposition	ripoʊsitaɪn	<ˌripəˈzɪʃən>
drape	dreɪp	<dreɪp>
myopia	maɪoʊpaɪeɪ	<maɪˈoʊpiə>
misconduct	mɪskɑndəkt	<mɪˈskɑndəkt>
thoracic	ðoʊrækɪk	<θɔˈræsɪk>
shingle	ʃɪngli	<ˈʃɪŋgəl>
lido	laɪdoʊ	<ˈlidoʊ>
dura	durɑ	<ˈdʊrə>
wally	wɑllaɪ	<ˈwɔli>
windward	wɪndwɔrd	<ˈwɪndwərd>
shearing	ʃɪrɪŋ	<ˈʃɪrɪŋ>
recognize	rɛkɑgnaɪz	<ˈrɛkəgˌnaɪz>
papaya	pɑpɑjɑ	<pəˈpaɪə>
soccer	sɑkkər	<ˈsɑkər>
discoveries	dɪskɑvəraɪz	<dɪˈskəvəriz>
prosecution	prɑsikutaɪn	<ˌprɑsəˈkjuʃən>
dove	duv	<dəv>
rebirth	ribərθ	<riˈbərθ>
plucker	pləkər	<ˈpləkər>
overtime	oʊvərtaɪm	<ˈoʊvərˌtaɪm>
unwittingly	ənwɪttɪŋlaɪ	<ənˈwɪtɪŋli>
journeyman	ʤʊrneɪmæn	<ˈʤərniˌmæn>
georgette	gərgɛt	<ʤɔˈrʤɛt>
worsen	wərzɛn	<ˈwərsən>
vinyl	vinɪl	<ˈvaɪnəl>
cans	kænz	<kænz>
parasitic	pɑreɪsɪtɪk	<ˌpɛrəˈsɪtɪk>
sleeper	slipər	<sˈlipər>
perversion	pərvərsɪn	<pərˈvərʒən>
medallion	midællɪn	<məˈdæljən>
trans	trænz	<trænz>
batteries	bættəraɪz	<ˈbætəriz>
supersonics	supərsɑnɪks	<ˌsupərˈsɑnɪks>
inspector	ɪnspɛktɔr	<ˌɪnˈspɛktər>
suitable	suteɪbli	<ˈsutəbəl>
allotment	ællɑtmɛnt	<əˈlɑtmənt>
carle	kɑr	<ˈkɑrəl>
trace	treɪs	<treɪs>
jive	ʤɪv	<ʤaɪv>
groove	gruv	<gruv>
inquiry	ɪnkwɪrjaɪ	<ˌɪnkˈwaɪˌri>
practicing	præktɪkɪŋ	<ˈpræktɪsɪŋ>
landlocked	lændlɑkt	<ˈlænˌdlɑkt>
greedy	gridjaɪ	<ˈgridi>
inflammation	ɪnflæmmɑtaɪn	<ˌɪnfləˈmeɪʃən>
acetone	ækitoʊn	<ˈæsəˌtoʊn>
enameled	inæmɛld	<ɪˈnæməld>
juncture	ʤənktʊr	<ˈʤəŋkʧər>
screwed	skrud	<skrud>
artifice	ɑrtifaɪs	<ˈɑrtəfɪs>
tommy	tɑmmaɪ	<ˈtɑmi>
brawl	brɔl	<brɔl>
tangent	tænʤɛnt	<ˈtænʤənt>
floor	flaʊər	<flɔr>
conveniently	kɑnvɛnɪntlaɪ	<kənˈvinjəntli>
muzzle	muzzi	<ˈməzəl>
impoundment	ɪmpaʊndmɛnt	<ˌɪmˈpaʊndmənt>
mana	mɑnɑ	<ˈmɑnə>
hypnotist	hɪpnoʊtɪst	<ˈhɪpnətɪst>
wearing	wɛrɪŋ	<ˈwɛrɪŋ>
farewell	fɛrwɛl	<ˌfɛrˈwɛl>
crayfish	kreɪfɪʃ	<ˈkreɪfɪʃ>
eugenics	juʤɛnɪks	<juˈʤɛnɪks>
possibility	pɑssibɪlaɪtaɪ	<ˌpɑsəˈbɪləˌti>
twin	twɪn	<twɪn>
jeans	ʤinz	<ʤinz>
more	mɔr	<mɔr>
delving	dɛlvɪŋ	<ˈdɛlvɪŋ>
adjacent	ædʤɑsɛnt	<əˈʤeɪsənt>
opportunity	ɑppɔrtunitaɪ	<ˌɑpərˈtunəti>
onus	oʊnuz	<ˈoʊnəs>
riverbank	rɪvərbæŋk	<ˈrɪvərˌbæŋk>
broke	broʊk	<broʊk>
password	pæswərd	<ˈpæsˌwərd>
hanger	hæŋər	<ˈhæŋər>
diner	dɪnər	<ˈdaɪnər>
feeble	fibli	<ˈfibəl>
composition	kɑmpoʊsitaɪn	<ˌkɑmpəˈzɪʃən>
spotted	spɑttɛd	<ˈspɑtɪd>
crum	krəm	<krəm>
pence	pɛns	<pɛns>
idle	aɪdɛl	<ˈaɪdəl>
ground	graʊnd	<graʊnd>
temperature	tɛmpəreɪtʊr	<ˈtɛmpərəʧər>
constructor	kɑnstrəktɔr	<kənˈstrəktər>
danger	dængər	<ˈdeɪnʤər>
becket	bɛkɛt	<ˈbɛkət>
medicine	mɛdaɪsaɪn	<ˈmɛdəsən>
allies	ællaɪz	<ˈælaɪz>
admirably	ædmirɑblaɪ	<ˈædmərəbli>
bass	bæs	<bæs>
philanthropic	fɪlænθrɑpɪk	<ˌfɪlənθˈrɑpɪk>
policy	pɑlaɪkaɪ	<ˈpɑləsi>
citadel	sɪteɪdɛl	<ˈsɪtəˌdɛl>
intense	ɪntɛns	<ˌɪnˈtɛns>
affirm	æffərm	<əˈfərm>
debarment	dibɑrmɛnt	<dɪˈbɑrmənt>
benzene	bɛnzin	<ˈbɛnzin>
hoop	hup	<hup>
tweedy	twidjaɪ	<tˈwidi>
rab	ræb	<ræb>
rescheduled	riskɛdjuld	<riˈskɛʤuld>
chimera	ʧaɪmirɑ	<ʧɪˈmɛrə>
rotation	roʊtɑtaɪn	<roʊˈteɪʃən>
naval	nɑvæl	<ˈneɪvəl>
hills	hɪls	<hɪlz>
intervened	ɪntərvind	<ˌɪntərˈvind>
patios	pɑtiɑs	<ˈpætiˌoʊz>
dammit	dæmmɪt	<ˈdæmɪt>
usefulness	juzfəlnɛs	<ˈjusfəlnəs>
indigenous	ɪndɪginuz	<ˌɪnˈdɪʤənəs>
aviator	eɪvieɪtɔr	<ˈeɪviˌeɪtər>
willingness	wɪlɪŋnɛs	<ˈwɪlɪŋnəs>
quorum	kwərəm	<kˈwɔrəm>
colloquial	kɑlloʊkwiæl	<kəˈloʊkwiəl>
geothermal	ʤioʊθərmæl	<ˌʤioʊˈθərməl>
yelp	jɛlp	<jɛlp>
exceedingly	ɛkssidɪŋlaɪ	<ɪkˈsidɪŋli>
autistic	oʊtɪstɪk	<ɔˈtɪstɪk>
fraternity	frɑtərnitaɪ	<frəˈtərnɪti>
dissociation	dɪssoʊkieɪtaɪn	<dɪˌsoʊsiˈeɪʃən>
assure	æsʃʊr	<əˈʃʊr>
plover	plɑvər	<ˈpləvər>
egregious	igrigaʊz	<ɪˈgriʤəs>
exemplary	ɛksɛmplɑraɪ	<ɪgˈzɛmpləri>
adversely	ædvərslaɪ	<ædˈvərsli>
novice	nɑvaɪs	<ˈnɑvəs>
foothold	futhoʊld	<ˈfʊˌthoʊld>
poisonous	pɔɪsɑnaʊz	<ˈpɔɪzənəs>
conte	kɑnt	<ˈkɔnteɪ>
affine	æffaɪn	<əˈfaɪn>
terra	tərrɑ	<ˈtɛˌrɑ>
revolve	rivəlv	<riˈvɑlv>
sear	sɪr	<sɪr>
stroke	stoʊk	<stroʊk>
salesperson	seɪlzpərsɑn	<ˈseɪlzˌpərsən>
keen	kin	<kin>
map	mæp	<mæp>
mound	maʊnd	<maʊnd>
retardation	ritɑrdɑtaɪn	<ritɑrˈdeɪʃən>
seedling	sidlɪŋ	<ˈsidlɪŋ>
lawless	lɔlɛs	<ˈlɔləs>
rechargeable	riʧɑrʤeɪbli	<riˈʧɑrʤəbəl>
convict	kɑnvɪkt	<ˈkɑnvɪkt>
marshmallow	mɑrʃmælloʊ	<ˈmɑrʃˌmɛloʊ>
boxer	bɑksər	<ˈbɑksər>
guns	gənz	<gənz>
cellulose	sɛlluloʊz	<ˈsɛljəˌloʊs>
trademark	treɪdmɑrk	<ˈtreɪdˌmɑrk>
exceptionally	ɛkssɛptaɪnællaɪ	<ɪkˈsɛpʃənəli>
blimp	blɪmp	<blɪmp>
evaluation	ivælueɪtaɪn	<ɪˌvæljuˈeɪʃən>
subsection	səbsɛktaɪn	<ˈsəbsɛkʃən>
laird	lɛrd	<lɛrd>
oral	oʊræl	<ˈɔrəl>
liberating	lɪbərætɪŋ	<ˈlɪˌbərˌeɪtɪŋ>
submit	səbmɪt	<səbˈmɪt>
crisscross	krɪskrɑs	<ˈkrɪˌskrɔs>
scrutiny	skrutinaɪ	<ˈskrutəni>
loathing	loʊθɪŋ	<ˈloʊθɪŋ>
deliciously	dilaɪkaʊzlaɪ	<dɪˈlɪʃəʃli>
lily	lɪljaɪ	<ˈlɪli>
deuterium	dutəraɪəm	<duˈtiriəm>
devious	diviaʊz	<ˈdiviəs>
constructive	kɑnstrəktaɪv	<kənˈstrəktɪv>
rarest	rɑrɛst	<ˈrɛrəst>
lech	lɛʧ	<lɛk>
unnecessary	ənnɛkɛssɑrjaɪ	<ənˈnɛsəˌsɛri>
overly	oʊvərlaɪ	<ˈoʊvərli>
nucleation	nuklieɪtaɪn	<ˌnukliˈeɪʃən>
attach	ættæʧ	<əˈtæʧ>
refined	rifaɪnd	<rɪˈfaɪnd>
libra	laɪbrɑ	<ˈlibrɑ>
joyous	ʤɔɪaʊz	<ʤɔɪəs>
absorbed	æbsɔrd	<əbˈzɔrbd>
henrietta	hɛnraɪɛttɑ	<ˌhɛnriˈɛtə>
refute	rifjut	<rɪfˈjut>
load	loʊd	<loʊd>
costly	kɑstlaɪ	<ˈkɔstli>
cotta	kɑttɑ	<ˈkɑtə>
display	dɪspleɪ	<dɪˈspleɪ>
song	sɑŋ	<sɔŋ>
pane	peɪn	<peɪn>
wired	waɪərd	<waɪərd>
vibrant	vibrænt	<ˈvaɪbrənt>
metabolism	mitæboʊlɪs	<məˈtæbəˌlɪzəm>
guardian	gɑrdaɪæn	<ˈgɑrdiən>
detritus	ditraɪtəs	<ˈdɛtrətəs>
waders	wɑdərs	<ˈweɪdərz>
trimming	trɪmmɪŋ	<ˈtrɪmɪŋ>
xenon	sɛnɑn	<ˈzinɑn>
attending	ættɛndɪŋ	<əˈtɛndɪŋ>
laughing	læfɪŋ	<ˈlæfɪŋ>
exercising	ɛksərsɪsɪŋ	<ˈɛksərˌsaɪzɪŋ>
mystery	mɪstərjaɪ	<ˈmɪstəri>
infinity	ɪnfɪnaɪtaɪ	<ˌɪnˈfɪnɪti>
soggy	sɑggaɪ	<ˈsɑgi>
importantly	ɪmpɔrtæntlaɪ	<ˌɪmˈpɔrtəntli>
selectively	silɛktaɪvlaɪ	<səˈlɛktɪvli>
candlelight	kændɛllaɪt	<ˈkændəˌllaɪt>
rho	roʊ	<roʊ>
unaffected	ənæffɛktɛd	<ˌənəˈfɛktɪd>
trump	trəmp	<trəmp>
boomer	bumər	<ˈbumər>
heartless	hɑrtlɛs	<ˈhɑrtləs>
avatar	æveɪtɑr	<ˈævəˌtɑr>
uncover	ənkɔv	<ənˈkəvər>
devotional	divoʊtaɪnæl	<dɪˈvoʊʃənəl>
content	kɑntɛnt	<ˈkɑntɛnt>
numerology	numɛroʊloʊgaɪ	<numərˈɑləʤi>
onward	ɑnwɔrd	<ˈɔnwərd>
office	ɑffaɪs	<ˈɔfəs>
thankfully	θæŋkfəllaɪ	<ˈθæŋkfəli>
aviation	eɪvieɪtaɪn	<ˌeɪviˈeɪʃən>
institutes	ɪnstaɪtut	<ˈɪnstɪˌtuts>
devour	divaʊr	<dɪˈvaʊər>
modeled	mɑdɛld	<ˈmɑdəld>
burl	bərl	<bərl>
tuff	təf	<təf>
puri	puraɪ	<ˈpʊri>
coffee	kɑffi	<ˈkɔfi>
situated	sɪtuætɛd	<ˈsɪʧuˌeɪtɪd>
toolbox	tulbɑks	<ˈtulˌbɔks>
activist	æktɪvɪst	<ˈæktɪvɪst>
damn	dæm	<dæm>
mitral	mitræl	<ˈmaɪtrəl>
hollow	hɑlloʊ	<ˈhɑloʊ>
insurer	ɪnsərər	<ˌɪnˈʃʊrər>
oozing	uzɪŋ	<ˈuzɪŋ>
boron	boʊrɑn	<ˈbɔˌrɑn>
wetting	wɛttɪŋ	<ˈwɛtɪŋ>
nineteenth	naɪntinθ	<ˈnaɪnˈtinθ>
black	blæk	<blæk>
nimble	nɪmbli	<ˈnɪmbəl>
ascend	æssɛnd	<əˈsɛnd>
mongolian	mɑngoʊlaɪæn	<mɑŋˈgoʊljən>
shortcake	ʃɔrtkeɪk	<ˈʃɔrtˌkeɪk>
defiance	difaɪæns	<dɪˈfaɪəns>
emergence	imɛrʤɛns	<ˈimərʤəns>
alms	æmz	<ɑmz>
stabilizer	stɑbaɪlɪzər	<ˈsteɪbəˌlaɪzər>
easy	izjaɪ	<ˈizi>
delinquent	dilɪnkwɛnt	<dɪˈlɪŋkwənt>
mpg	mpɑg	<ˈɛmˈpiˈʤi>
tonga	tɑngɑ	<ˈtɑngə>
bower	boʊər	<baʊər>
fulfillment	fəlfɪlmɛnt	<fʊlˈfɪlmənt>
handed	hændɛd	<ˈhændɪd>
ultrasound	əltrɑsaʊnd	<ˌəltrəˈsaʊnd>
encapsulating	ɛnkæpsulætɪŋ	<ɛnˈkæpsəˌleɪtɪŋ>
review	rivju	<ˌrivˈju>
prawn	prɔn	<prɔn>
unfinished	ənfɪnaɪʃd	<ənˈfɪnɪʃt>
hock	hɑk	<hɑk>
spiritual	spɪrɪtuæl	<ˈspɪrɪˌʧuəl>
foreclosed	fɔrkloʊzd	<fɔrˈkloʊzd>
brain	breɪn	<breɪn>
horror	hərrər	<ˈhɔrər>
sowing	soʊɪŋ	<soʊɪŋ>
dissimilar	dɪssɪmaɪlɑr	<dɪˈsɪmələr>
endorsed	ɛndɔrzd	<ɛnˈdɔrst>
kingdom	kɪŋdɑm	<ˈkɪŋdəm>
stave	steɪv	<steɪv>
ways	weɪz	<weɪz>
gourd	gɔrd	<gɔrd>
whatever	wɑtɛvər	<ˌwəˈtɛvər>
amplification	æmplaɪfaɪkɑtaɪn	<ˌæmpləfəˈkeɪʃən>
obituaries	oʊbɪtuɑraɪz	<oʊˈbɪʧuˌɛriz>
remote	rimoʊt	<rɪˈmoʊt>
profiling	proʊfɪlɪŋ	<ˈproʊˌfaɪlɪŋ>
displace	dɪspleɪs	<dɪˈspleɪs>
who	hoʊ	<hu>
providing	proʊvɪdɪŋ	<prəˈvaɪdɪŋ>
sadness	sædnɛs	<ˈsædnəs>
inherent	ɪnhərɛnt	<ˌɪnˈhɛrənt>
outage	aʊteɪʤ	<ˈaʊtɪʤ>
combined	kɑmbaɪnd	<kəmˈbaɪnd>
crumble	krəmbli	<ˈkrəmbəl>
basic	bɑsɪk	<ˈbeɪsɪk>
goblin	gɑblɪn	<ˈgɑblɪn>
rolling	roʊlɪŋ	<ˈroʊlɪŋ>
kilogram	kɪloʊgræm	<ˈkɪləˌgræm>
bogus	boʊgəs	<ˈboʊgəs>
sanctification	sænktifaɪkɑtaɪn	<ˌsæŋktəfəˈkeɪʃən>
prospective	proʊspɛktaɪv	<prəˈspɛktɪv>
statute	stætjut	<ˈstæʧut>
normality	nɔrmælaɪtaɪ	<ˌnɔrˈmæləti>
hamlet	hæmlɛt	<ˈhæmlɪt>
giles	gaɪlz	<ʤaɪlz>
cock	kɑk	<kɑk>
orally	oʊrællaɪ	<ˈɔrəli>
normally	nɔrmællaɪ	<ˈnɔrməli>
tripping	trɪppɪŋ	<ˈtrɪpɪŋ>
unanimity	unɑnɪmaɪtaɪ	<ˌjunəˈnɪmɪti>
automatic	oʊtoʊmætɪk	<ˌɔtəˈmætɪk>
shanghai	ʃæŋheɪ	<ˈʃæŋˈhaɪ>
howdy	haʊdaɪ	<ˈhaʊdi>
botanical	boʊtænaɪkæl	<bəˈtænɪkəl>
lengthy	lɛŋθjaɪ	<ˈlɛŋθi>
pliable	plaɪeɪbli	<ˈplaɪəbəl>
uninhabited	ənɪnhɑbɪtɛd	<ˌənɪnˈhæbətɪd>
socialism	soʊkilɪs	<ˈsoʊʃəˌlɪzəm>
ravioli	rɑvioʊlaɪ	<ˌræviˈoʊli>
inlet	ɪnlɛt	<ˈɪnˌlɛt>
sadly	sædlaɪ	<ˈsædli>
renown	rinaʊn	<rɪˈnaʊn>
logos	lɑgɑs	<ˈloʊˌgoʊz>
grievance	grivæns	<ˈgrivəns>
vector	vɛktɔr	<ˈvɛktər>
manhood	mænhʊd	<ˈmænˌhʊd>
rewrote	riroʊt	<riˈroʊt>
kamikaze	kɑmikɑzi	<ˌkɑməˈkɑzi>
queen	kwin	<kwin>
sauce	sɔs	<sɔs>
barre	bɑr	<ˈbɛri>
innovator	ɪnnoʊvɑtɔr	<ˈɪnəˌveɪtər>
wiring	wərɪŋ	<ˈwaɪrɪŋ>
courtyard	kɔrtjɑrd	<ˈkɔrˌtjɑrd>
telford	tɛlfɔrd	<ˈtɛlfərd>
nomadic	noʊmædɪk	<noʊˈmædɪk>
tenure	tɛnjur	<ˈtɛnjər>
leisurely	liʃʊrlaɪ	<ˈlizərli>
sea	si	<si>
farmhouse	fɑrmhaʊs	<ˈfɑrmˌhaʊs>
still	stɪl	<stɪl>
poised	paɪzd	<pɔɪzd>
bundle	bəndɛl	<ˈbəndəl>
choruses	ʧoʊrəsɛs	<ˈkɔrəsɪz>
doubling	dublɪŋ	<ˈdəbəlɪŋ>
spokeswoman	spoʊkswɑmæn	<ˈspoʊksˌwʊmən>
seating	sitɪŋ	<ˈsitɪŋ>
burg	bərg	<bərg>
agency	eɪʤɛnkaɪ	<ˈeɪʤənsi>
dipping	dɪppɪŋ	<ˈdɪpɪŋ>
bobcat	bɑbkæt	<ˈbɑbˌkæt>
psychotherapist	paɪʧoʊθəreɪpɪst	<ˌsaɪkəˈθɛrəpɪst>
brainstorm	breɪnstɔrm	<ˈbreɪnˌstɔrm>
soothing	suθɪŋ	<ˈsuðɪŋ>
shew	ʃu	<ʃu>
vetting	vɛttɪŋ	<ˈvɛtɪŋ>
interferometer	ɪntərfərɑmitər	<ˌɪntərfərˈɑmətər>
seed	sid	<sid>
surveyor	sərveɪər	<ˈsərˌveɪər>
realtor	riæltɔr	<ˈriəltər>
inductor	ɪndəktɔr	<ˌɪnˈdəktər>
compendium	kɑmpɛndaɪəm	<kəmˈpɛndiəm>
bighorn	bɪghɔrn	<ˈbɪˌghɔrn>
inter	ɪnt	<ˌɪnˈtər>
sheriff	ʃərɪf	<ˈʃɛrɪf>
splits	spɪts	<splɪts>
disabled	dɪseɪblɛd	<dɪˈseɪbəld>
engraved	ɛngreɪvd	<ɪnˈgreɪvd>
construed	kɑnstrud	<kənˈstrud>
barefoot	bɛrfut	<ˈbɛrˌfʊt>
moustache	maʊzteɪʧ	<ˈməˌstæʃ>
wallet	wɑllɛt	<ˈwɔlət>
babble	bæbbli	<ˈbæbəl>
sabotage	sæboʊteɪʤ	<ˈsæbəˌtɑʒ>
grader	grædər	<ˈgreɪdər>
complement	kɑmplimɛnt	<ˈkɑmpləmənt>
presentation	prɛzɛntɑtaɪn	<ˌprɛzənˈteɪʃən>
canto	kæntoʊ	<ˈkæntoʊ>
mam	mæm	<ˈɛˈmeɪˈɛm>
quiescent	kwiɛssɛnt	<kwaɪˈɛsənt>
rollback	roʊlbæk	<ˈroʊlˌbæk>
overgrown	oʊvərgraʊn	<ˌoʊvərˈgroʊn>
freighter	freɪtər	<ˈfreɪtər>
doc	dɑk	<dɑk>
health	hɛlθ	<hɛlθ>
transistor	trænsɪstɔr	<trænˈzɪstər>
piled	paɪld	<paɪld>
juror	ʤurər	<ˈʤʊrər>
multiply	məltiplaɪ	<ˈməltəˌplaɪ>
citric	sɪtrɪk	<ˈsɪtrɪk>
bone	boʊn	<boʊn>
counteract	kaʊntərækt	<ˈkaʊntərˌækt>
layer	leɪər	<leɪər>
scarlet	skɑrlɛt	<ˈskɑrlət>
walker	wɔkər	<ˈwɔkər>
come	koʊm	<kəm>
component	kɑmpoʊnɛnt	<kəmˈpoʊnənt>
experimentation	ɛkspəraɪmɛntɑtaɪn	<ɪkˌspɛrəmənˈteɪʃən>
injured	ɪnʤʊrd	<ˈɪnʤərd>
communicated	kɑmmunikætɛd	<kəmˈjunəˌkeɪtɪd>
interferon	ɪntərfərɑn	<ˌɪntərˈfɪrɑn>
etna	ɛtnɑ	<ˈɛtnə>
carver	kɑrvər	<ˈkɑrvər>
candidate	kændaɪdeɪt	<ˈkænədɪt>
someplace	soʊmpleɪs	<ˈsəmˌpleɪs>
heartbeat	hɑrtbit	<ˈhɑrtˌbit>
informational	ɪnfɔrmɑtaɪnæl	<ˌɪnˈfɔrˌmeɪʃənəl>
brink	brɪŋk	<brɪŋk>
sunshine	sənʃaɪn	<ˈsənˌʃaɪn>
mary	mɑrjaɪ	<ˈmɛri>
dress	drɛs	<drɛs>
pretzel	prɛtzɛl	<ˈprɛtzəl>
cast	kæst	<kæst>
deploy	diplɔɪ	<dɪˈplɔɪ>
insatiable	ɪnsɑtaɪbli	<ˌɪnˈseɪʃəbəl>
appropriation	æpproʊpraɪeɪtaɪn	<əˌproʊpriˈeɪʃən>
boot	but	<but>
fracture	fræktʊr	<ˈfrækʧər>
suggestive	səgʤɛstaɪv	<səˈʤɛstɪv>
ver	vər	<vər>
excavating	ɛkskɑvætɪŋ	<ˈɛkskəˌveɪtɪŋ>
gesellschaft	ʤisɛlʃæft	<gəˈsɛlʃæft>
counselor	kaʊnsilɔr	<ˈkaʊnsələr>
oar	ɔr	<ɔr>
inpatient	ɪnpɑtaɪnt	<ˈɪnˌpeɪʃənt>
hummingbird	həmmɪŋbərd	<ˈhəmɪŋˌbərd>
pounce	paʊns	<paʊns>
bellied	bɛllaɪd	<ˈbɛlid>
contact	kɑntækt	<ˈkɑnˌtækt>
flower	floʊər	<flaʊər>
bode	boʊd	<boʊd>
balloon	bællun	<bəˈlun>
magnetically	mægnɛtaɪkællaɪ	<mægˈnɛtɪkəli>
organ	ərgæn	<ˈɔrgən>
glycogen	glaɪkoʊʤɛn	<ˈglaɪkəʤɪn>
actually	æktuællaɪ	<ˈæˌkʧuəli>
magnificent	mægnɪfaɪsɛnt	<mægˈnɪfɪsənt>
infringing	ɪnfrɪŋɪŋ	<ˌɪnˈfrɪnʤɪŋ>
luminescence	luminɛssɛns	<ˌluməˈnɛsəns>
retire	ritaɪər	<ˌriˈtaɪər>
raisin	reɪsɪn	<ˈreɪzɪn>
deck	dɛk	<dɛk>
bleeding	blidɪŋ	<ˈblidɪŋ>
misdemeanor	mɪsdiminər	<ˌmɪsdəˈminər>
waterproof	wɑtərpruf	<ˈwɔtərˌpruf>
humidifier	humɪdaɪfaɪər	<hjuˈmɪdəˌfaɪər>
timepiece	taɪmpaɪs	<ˈtaɪmˌpis>
ascertain	æskərteɪn	<ˌæsərˈteɪn>
journalist	ʤʊrnælɪst	<ˈʤərnəlɪst>
thrift	θrɪft	<θrɪft>
bourgeoisie	baʊərgeɪsi	<ˌbʊrʒˌwɑˈzi>
custodian	kəstoʊdaɪæn	<kəˈstoʊdiən>
auth	ɔθ	<ɔθ>
neuropathy	nurɑpeɪðaɪ	<ˌnʊˈrɔpəθi>
chromosome	ʧroʊmoʊsoʊm	<ˈkroʊməˌzoʊm>
coliform	kɑlaɪfɔrm	<ˈkɔləˌfɔrm>
cashew	kæʃju	<ˈkæˌʃu>
express	ɛksprɛs	<ɪkˈsprɛs>
firmness	fərmnɛs	<ˈfərmnəs>
dogged	dɑgʤɛd	<dɔgd>
war	wɑr	<wɔr>
experience	ɛkspiraɪɛns	<ɪkˈspɪriəns>
concluded	kɑnklədɛd	<kənˈkludɪd>
mortuary	mɔrtuɑrjaɪ	<ˈmɔrʧuˌɛri>
documentary	dɑkumɛntɑraɪ	<ˌdɑkjəˈmɛnəri>
bracelet	breɪslɛt	<ˈbreɪslət>
lube	lub	<lub>
optimistic	ɑptimɪstɪk	<ˌɑptɪˈmɪstɪk>
arbiter	ɑrbaɪtər	<ˈɑrbɪtər>
edit	daɪt	<ˈɛdət>
fanny	fænnaɪ	<ˈfæni>
enduring	ɛndərɪŋ	<ɪnˈdʊrɪŋ>
experienced	ɛkspiraɪɛnst	<ɪkˈspɪriənst>
launch	lənʧ	<lɔnʧ>
grained	greɪnd	<greɪnd>
nonlinear	nɑnlɪniɑr	<nɑnˈlɪˌniər>
leather	liθər	<ˈlɛðər>
optical	ɑptikæl	<ˈɑptɪkəl>
waning	wɑnɪŋ	<ˈweɪnɪŋ>
tom	tɑm	<tɑm>
cassie	kæssi	<ˈkæsi>
flashback	flæʃbæk	<ˈflæʃˌbæk>
objector	ɑbʤɛktɔr	<əˈbʤɛktər>
fairly	fɛrlaɪ	<ˈfɛrli>
tribute	trɪbjut	<ˈtrɪbjut>
colt	kɑlt	<koʊlt>
moxie	mɑksaɪ	<ˈmɑksi>
weird	wɪrd	<wɪrd>
diurnal	daɪərnæl	<daɪəˈrnəl>
scan	skæn	<skæn>
requisite	rɛkjusaɪt	<ˈrɛkwəzət>
drive	draɪv	<draɪv>
particle	pɑrtikli	<ˈpɑrtɪkəl>
medicinal	midɪkaɪnæl	<məˈdɪsənəl>
light	laɪt	<laɪt>
diagnostic	daɪægnɑstɪk	<ˌdaɪəgˈnɑstɪk>
mullen	məllɛn	<ˈmələn>
upheaval	əphivæl	<əˈphivəl>
divisive	daɪvisaɪv	<dɪˈvaɪsɪv>
gertrude	gərtrud	<ˈgərtrud>
outrageously	aʊtrɑguzlaɪ	<ˌaʊˈtreɪʤəsli>
county	kaʊntaɪ	<ˈkaʊnti>
hibernate	haɪbərneɪt	<ˈhaɪbərˌneɪt>
horrible	hərraɪbli	<ˈhɔrəbəl>
pos	pɑs	<ˈpiˈoʊˈɛs>
landmark	lændmɑrk	<ˈlændˌmɑrk>
massaging	mæssægɪŋ	<məˈsɑʒɪŋ>
fish	fɪʃ	<fɪʃ>
deacon	dikɑn	<ˈdikən>
abound	eɪbaʊnd	<əˈbaʊnd>
bordered	bɔrdɛrd	<ˈbɔrdərd>
puff	pəf	<pəf>
scraper	skræpər	<ˈskreɪpər>
hacking	hækɪŋ	<ˈhækɪŋ>
rebound	ribaʊnd	<riˈbaʊnd>
destitute	dɛstitut	<ˈdɛstəˌtut>
encyclopaedia	ɛnkaɪkloʊpeɪdaɪeɪ	<ɪnˌsaɪkləˈpidiə>
lawyer	lɔjər	<ˈlɔjər>
pest	pɛst	<pɛst>
vascular	væskulɑr	<ˈvæskjələr>
headquarter	hɛdkwɑrtər	<ˈhɛdˌkɔrtər>
dwelling	dilɪŋ	<dˈwɛlɪŋ>
signature	sɪgnɑtʊr	<ˈsɪgnəʧər>
celery	sɛlərjaɪ	<ˈsɛləri>
motive	moʊtaɪv	<ˈmoʊtɪv>
girdle	gərdɛl	<ˈgərdəl>
fucking	ˈfəɪŋ	<ˈfəkɪŋ>
synonym	sɪnoʊnɪm	<ˈsɪnəˌnɪm>
pipe	paɪp	<paɪp>
prodigal	prɑdaɪgæl	<ˈprɑdɪgəl>
categorization	kætigoʊraɪzɑtaɪn	<ˌkætəgərɪˈzeɪʃən>
baa	bæ	<ˌbiˌeɪˈeɪ>
piston	pɪstɑn	<ˈpɪstən>
desperate	dɛspəreɪt	<ˈdɛspərɪt>
ilk	ɪlk	<ɪlk>
endogenous	ɛndɑginuz	<ˌɛnˈdɔʤɛnəs>
overpriced	oʊvərpraɪzd	<ˈoʊvərˌpraɪst>
gardener	gɑrdɛnər	<ˈgɑrdənər>
sham	ʃæm	<ʃæm>
hob	hɑb	<hɑb>
shoemaker	ʃoʊmækər	<ˈʃuˌmeɪkər>
playmate	pleɪmeɪt	<ˈpleɪˌmeɪt>
wishful	wɪʃfəl	<ˈwɪʃfəl>
lustre	luztri	<ˈləstər>
engrossing	ɛngrɑsɪŋ	<ɪnˈgroʊsɪŋ>
soundly	saʊndlaɪ	<ˈsaʊndli>
converging	kɑnvərgɪŋ	<kənˈvərʤɪŋ>
clemency	klɛmɛnkaɪ	<ˈklɛmənsi>
penny	pɛnnaɪ	<ˈpɛni>
gentlewoman	ʤɛntiwɑmæn	<ˈʤɛnəlˌwʊmən>
app	æp	<æp>
bystander	baɪstændər	<ˈbaɪˌstændər>
slew	slu	<slu>
sigma	sɪgmɑ	<ˈsɪgmə>
peasant	pizænt	<ˈpɛzənt>
lubricating	lubraɪkætɪŋ	<ˈlubrəˌkeɪtɪŋ>
epistemic	ɛpɪstɛmɪk	<ˌɛpɪˈstɛmɪk>
bloc	blɑk	<blɑk>
imbalance	ɪmbælæns	<ɪmˈbæləns>
simulated	sɪmulætɛd	<ˈsɪmjəˌleɪtɪd>
civilization	kɪvaɪlaɪzɑtaɪn	<ˌsɪvəlɪˈzeɪʃən>
retrieved	ritrivd	<riˈtrivd>
panther	pænθər	<ˈpænθər>
tolerate	tɑləreɪt	<ˈtɑlərˌeɪt>
carry	kɑrraɪ	<ˈkɛri>
discriminated	dɪskrɪmaɪnætɛd	<dɪˈskrɪməˌneɪtɪd>
gemma	ʤɛmmɑ	<ˈʤɛmə>
dorr	dɔr	<dɔr>
wholesale	hoʊlseɪl	<ˈhoʊlˌseɪl>
birthright	bərθraɪt	<ˈbərθˌraɪt>
title	titi	<ˈtaɪtəl>
shade	ʃeɪd	<ʃeɪd>
temporary	tɛmpoʊrɑrjaɪ	<ˈtɛmpərˌɛri>
mercury	mɛrkuraɪ	<ˈmərkjəri>
foxes	fɑksɛs	<ˈfɑksəz>
cheesecake	ʧizkeɪk	<ˈʧizˌkeɪk>
foolish	fulɪʃ	<ˈfulɪʃ>
tailgate	teɪlgeɪt	<ˈteɪlˌgeɪt>
attainment	ætteɪnmɛnt	<əˈteɪnmənt>
generated	ʤɛnərætɛd	<ˈʤɛnərˌeɪtɪd>
sole	soʊl	<soʊl>
waive	weɪv	<weɪv>
flawed	fleɪd	<flɔd>
forerunner	fɔrrənnɛr	<ˈfɔˌrənər>
centrifuge	sɛntraɪfjuʤ	<ˈsɛntrəfˌjuʤ>
mantra	mæntrɑ	<ˈmæntrə>
ambler	æmblɛr	<ˈæmblər>
place	pleɪs	<pleɪs>
electric	ilɛktrɪk	<ɪˈlɛktrɪk>
dulcimer	dəlkimɛr	<ˈdəlsɪmər>
calvary	kælvɑraɪ	<ˈkælvəri>
systematic	sɪstɛmætɪk	<ˌsɪstəˈmætɪk>
superficial	supərfaɪkil	<ˌsupərˈfɪʃəl>
napping	næppɪŋ	<ˈnæpɪŋ>
ditch	dɪʧ	<dɪʧ>
narrows	nɑrraʊz	<ˈnɛroʊz>
rematch	rimæʧ	<ˈriˈmæʧ>
victoria	vɪktoʊraɪeɪ	<vɪkˈtɔriə>
contrary	kɑntrɑraɪ	<ˈkɑntrɛri>
horoscope	həroʊskoʊp	<ˈhɔrəˌskoʊp>
secrecy	sikrikaɪ	<ˈsikrəsi>
finale	faɪnɑli	<fəˈnæli>
gutted	gəttɛd	<ˈgətɪd>
mirage	mireɪʤ	<mərɑʒ>
technically	tɛʧnikællaɪ	<ˈtɛknɪkəli>
stang	stæŋ	<stæŋ>
presbyterian	prɛzbaɪtəraɪæn	<ˌprɛzbɪˈtɪriən>
receptionist	risɛptaɪnɪst	<rɪˈsɛpʃənɪst>
amino	eɪminoʊ	<əˈminoʊ>
canon	kænɑn	<ˈkænən>
dot	dɑt	<dɑt>
resistant	risɪstænt	<rɪˈzɪstənt>
qualify	kwɑlaɪfaɪ	<kˈwɑləˌfaɪ>
truncate	trənkeɪt	<ˈtrəŋˌkeɪt>
sage	seɪʤ	<seɪʤ>
minimalist	mɪnaɪmælɪst	<ˈmɪnəməlɪst>
special	spikil	<ˈspɛʃəl>
operation	ɑpəreɪtaɪn	<ˌɑpərˈeɪʃən>
doubtless	daʊbtlɛs	<ˈdaʊtləs>
poet	poʊt	<poʊət>
cancel	kænsɛl	<ˈkænsəl>
ensign	ɛnsɪŋ	<ˈɛnsən>
referral	rifərræl	<rɪˈfərəl>
postmortem	pɑstmɔrtɛm	<poʊstˈmɔrtɛm>
gaz	gæz	<gɑz>
pathogenic	pæθoʊʤɛnɪk	<ˌpæθəˈʤɛnɪk>
aback	eɪbæk	<əˈbæk>
weightlifting	weɪtlɪftɪŋ	<ˈweɪˌtlɪftɪŋ>
league	lig	<lig>
station	stɑtaɪn	<ˈsteɪʃən>
chic	ʧɪk	<ʃik>
arteriosclerosis	ɑrtiraɪoʊskiroʊsɪs	<ɑrˌtɪrioʊsklərˈoʊsəs>
cancelled	kænkɛld	<ˈkænsəld>
finest	fɪnɛst	<ˈfaɪnəst>
gemini	ʤɛmaɪni	<ˈʤɛməˌni>
diocesan	daɪɑkisæn	<daɪˈɑsəsən>
concurrent	kɑnkərrɛnt	<kənˈkərənt>
accreditation	ækkrɛdaɪtɑtaɪn	<əˌkrɛdəˈteɪʃən>
aline	eɪlaɪn	<əˈlaɪn>
shopkeeper	ʃɑpkipər	<ˈʃɑpˌkipər>
prejudice	priudaɪs	<ˈprɛʤədɪs>
hypoxia	haɪpɑksaɪeɪ	<haɪˈpɑksiə>
satire	sætaɪər	<ˈsæˌtaɪər>
abridged	eɪbrɪʤd	<əˈbrɪʤd>
necessitated	nisɛssitætɛd	<nəˈsɛsəˌteɪtəd>
ribbon	rɪbbɑn	<ˈrɪbən>
jackal	ʤækæl	<ˈʤækəl>
trucking	təkɪŋ	<ˈtrəkɪŋ>
tenant	tɛnænt	<ˈtɛnənt>
mantua	mæntueɪ	<ˈmænʧuə>
comes	koʊmɛs	<kəmz>
delegated	dɛligætɛd	<ˈdɛləˌgeɪtəd>
transitional	trænsitaɪnæl	<trænˈzɪʃənəl>
guaranty	gəræntaɪ	<ˌgɛrənˈti>
equipped	ikwɪpt	<ɪkˈwɪpt>
righteous	raɪtuz	<ˈraɪʧəs>
miniskirt	mɪnaɪskərt	<ˈmɪniˌskərt>
incurring	ɪnkərrɪŋ	<ˌɪnˈkərɪŋ>
around	eɪraʊnd	<əraʊnd>
drugstore	drəgstɔr	<ˈdrəgˌstɔr>
putative	putɑtaɪv	<ˈpjutətɪv>
twofold	tufoʊld	<ˈtuˈfoʊld>
container	kɑnteɪnər	<kənˈteɪnər>
consolidating	kɑnsɑlaɪdætɪŋ	<kənˈsɑləˌdeɪtɪŋ>
separate	sɛpeɪreɪt	<ˈsɛpərˌeɪt>
wellness	wɛlnɛs	<ˈwɛlnəs>
cathode	kæθoʊd	<ˈkæˌθoʊd>
glorified	gloʊraɪfaɪd	<ˈglɔrəˌfaɪd>
ester	ɛstər	<ˈɛstər>
initiative	ɪnaɪtieɪtaɪv	<ˌɪˈnɪʃətɪv>
little	lɪtti	<ˈlɪtəl>
summing	səmmɪŋ	<ˈsəmɪŋ>
distinguished	dɪstɪngɪʃd	<dɪˈstɪŋgwɪʃt>
carried	kɑrrid	<ˈkɛrid>
phenotype	finoʊtaɪp	<ˈfinəˌtaɪp>
clarifying	klɑraɪfaɪɪŋ	<ˈklɛrəˌfaɪɪŋ>
hero	hiroʊ	<ˈhɪroʊ>
lipoprotein	lɪpoʊproʊtin	<ˌlɪpəˈproʊtin>
grandparent	grændpɑrɛnt	<ˈgrændˌpɛrənt>
forgot	fɔrgɑt	<fərˈgɑt>
similarity	sɪmaɪlɑraɪtaɪ	<ˌsɪməˈlɛrəti>
ami	eɪmi	<ˈɑmi>
ciao	kaʊ	<ʧaʊ>
exhibitionist	ɛkshaɪbaɪtaɪnɪst	<ˌɛksəˈbɪʃənɪst>
barbarian	bɑrbɑraɪæn	<bɑrˈbɛriən>
earthly	ərθlaɪ	<ˈərθli>
trimmer	trɪmmɛr	<ˈtrɪmər>
sheik	ʃik	<ʃik>
oncoming	ɑnkɑmɪŋ	<ˈɔnˌkəmɪŋ>
nymph	nɪmf	<nɪmf>
fragility	frɑgɪlaɪtaɪ	<frəˈʤɪləti>
loafer	loʊfər	<ˈloʊfər>
reconnaissance	rikɑnneɪzsæns	<riˈkɑnəsəns>
compliment	kɑmplaɪmɛnt	<ˈkɑmpləmɛnt>
frown	fraʊn	<fraʊn>
insensitive	ɪnsɛnsitaɪv	<ˌɪnˈsɛnsɪtɪv>
echoes	ɛʧoʊz	<ˈɛkoʊz>
comb	kɑm	<koʊm>
swore	swaʊr	<swɔr>
cocktail	kɑkteɪl	<ˈkɑkˌteɪl>
rainbow	reɪnboʊ	<ˈreɪnˌboʊ>
teller	tɛlər	<ˈtɛlər>
splinter	spɪntər	<ˈsplɪntər>
smog	smɑg	<smɑg>
tapas	tɑpæs	<ˈtəpəs>
beeper	bipər	<ˈbipər>
frontage	frənteɪʤ	<ˈfrəntɪʤ>
coefficient	koʊɛffaɪsaɪnt	<ˌkoʊəˈfɪʃənt>
whistler	wɪztlɛr	<ˈwɪslər>
fumble	fəmbli	<ˈfəmbəl>
electricity	ilɛktrɪkaɪtaɪ	<ɪˌlɛkˈtrɪsəti>
reserve	risərv	<rɪˈzərv>
increment	ɪnkrimɛnt	<ˈɪnkrəmənt>
preserve	prisərv	<prɪˈzərv>
disparate	dɪspɑreɪt	<ˈdɪspərɪt>
unknown	ənnoʊn	<ənˈnoʊn>
aggressiveness	æggrɛssaɪvnɛs	<əˈgrɛsɪvnəs>
gotta	gɑttɑ	<ˈgɑtə>
silicate	sɪlaɪkeɪt	<ˈsɪləˌkeɪt>
rejoiced	riʤɔɪst	<rɪˈʤɔɪst>
chopper	ʧɑppər	<ˈʧɑpər>
thesaurus	ðisoʊrəs	<θəˈsɔrəs>
pantry	pæntraɪ	<ˈpæntri>
noir	nɔɪr	<nɔɪr>
protege	proʊtiʤi	<ˈproʊtəˌʒeɪ>
privates	praɪveɪts	<ˈpraɪvəts>
excluding	ɛksklədɪŋ	<ɪkˈskludɪŋ>
fetish	fɛtɪʃ	<ˈfɛtɪʃ>
uneven	ənivɛn	<əˈnivən>
mixture	mɪkstʊr	<ˈmɪksʧər>
assets	æssɛts	<ˈæˌsɛts>
proven	prɑvɛn	<ˈpruvən>
gifted	gɪftɛd	<ˈgɪftɪd>
tedious	tidaɪaʊz	<ˈtidiəs>
gliding	glɪdɪŋ	<ˈglaɪdɪŋ>
forgiven	fɔrʤɪvɛn	<fərˈgɪvən>
frankly	fræŋklaɪ	<ˈfræŋkli>
adolescence	ædoʊlɛssɛns	<ˌædəˈlɛsəns>
barrage	bɑrreɪʤ	<bərɑʒ>
sunlight	sənlaɪt	<ˈsənˌlaɪt>
camouflage	kæmufleɪʤ	<ˈkæməˌflɑʒ>
innumerable	ɪnnumɛreɪbli	<ˌɪˈnumərəbəl>
unitarian	unitɑraɪæn	<ˌjunəˈtɛriən>
sweeps	swip	<swips>
perilous	pəraɪlaʊz	<ˈpɛrələs>
flywheel	flaɪwil	<ˈflaɪˌwil>
juice	ʤus	<ʤus>
aria	eɪraɪeɪ	<ˈɑriə>
sabin	sɑbɪn	<ˈseɪbɪn>
inoperative	ɪnɑpəreɪtaɪv	<ˌɪˈnɑpərətɪv>
rewriting	rirɪtɪŋ	<riˈraɪtɪŋ>
fort	fɔrt	<fɔrt>
inshore	ɪnʃɔr	<ˈɪnˈʃɔr>
typesetting	taɪpsɛttɪŋ	<ˈtaɪpˌsɛtɪŋ>
smile	smaɪl	<smaɪl>
vulva	vəlvɑ	<ˈvʊlvə>
twig	tɪg	<twɪg>
action	æktaɪn	<ˈækʃən>
wiggle	wɪggli	<ˈwɪgəl>
savor	sɑvɔr	<ˈseɪvər>
detail	diteɪl	<ˈditeɪl>
forwarding	fɔrwɔrdɪŋ	<ˈfɔrwərdɪŋ>
audience	oʊdaɪɛns	<ˈɔdiəns>
haste	heɪst	<heɪst>
purchase	pərʧeɪz	<ˈpərʧəs>
triangulation	traɪængulɑtaɪn	<traɪˌæŋgjuˈleɪʃən>
shakedown	ʃeɪkdaʊn	<ˈʃeɪkˌdaʊn>
override	oʊvərraɪd	<ˈoʊvərˌraɪd>
thoughtful	θɔtfəl	<ˈθɔtfəl>
quizzes	kwɪzzɛs	<kˈwɪzɪz>
larder	lɑrdər	<ˈlɑrdər>
brick	brɪk	<brɪk>
emigrant	ɛmaɪgrænt	<ˈɛməgrənt>
capo	kɑpoʊ	<ˈkɑpoʊ>
unannounced	ənænnaʊns	<ˌənəˈnaʊnst>
alleviating	ælliviætɪŋ	<əˈliviˌeɪtɪŋ>
donny	dɑnnaɪ	<ˈdɑni>
there	ðɛr	<ðɛr>
comptroller	kɑmptrɑllər	<ˈkɑmˌtroʊlər>
vista	vɪstɑ	<ˈvɪstə>
equitable	ɛkjutɑbli	<ˈɛkwɪtəbəl>
skew	skju	<skju>
gents	ʤɛnts	<ʤɛnts>
mako	mɑkoʊ	<ˈmɑkoʊ>
skater	skætər	<ˈskeɪtər>
influencing	ɪnfluɛnkɪŋ	<ˈɪnˌfluənsɪŋ>
insufficient	ɪnsəffaɪsaɪnt	<ˌɪnsəˈfɪʃənt>
inbound	ɪnbaʊnd	<ˌɪnˈbaʊnd>
accepted	ækkɛptɛd	<ækˈsɛptɪd>
spruce	spru	<sprus>
etcetera	ɛtsɛtəreɪ	<ˈɛtˈsɛtərə>
blade	bleɪd	<bleɪd>
yoke	joʊk	<joʊk>
stove	stoʊv	<stoʊv>
unavailable	əneɪveɪleɪbli	<ˌənəˈveɪləbəl>
sickly	sɪklaɪ	<ˈsɪkli>
spay	speɪ	<speɪ>
jaeger	ʤeɪgər	<ˈʤɛgər>
unattended	ənættɛndɛd	<ənəˈtɛndɪd>
petitioner	pititaɪnər	<pəˈtɪʃənər>
realised	riælaɪzd	<ˈriəˌlaɪzd>
disable	dɪseɪbli	<dɪˈseɪbəl>
usual	usuæl	<ˈjuʒəwəl>
griffin	grɪffɪn	<ˈgrɪfɪn>
organist	ərgænɪst	<ˈɔrgənəst>
idealism	aɪdiælɪs	<aɪˈdilɪzəm>
placing	plækɪŋ	<ˈpleɪsɪŋ>
respectable	rispɛkteɪbli	<rɪˈspɛktəbəl>
redding	rɛdɪŋ	<ˈrɛdɪŋ>
remuneration	rimunɛreɪtaɪn	<rɪmˌjunərˈeɪʃən>
vessel	vɛssɛl	<ˈvɛsəl>
stalked	stɔkt	<stɔkt>
density	dɛnsitaɪ	<ˈdɛnsɪti>
adieu	eɪdaɪ	<əˈdu>
homesick	hoʊmsɪk	<ˈhoʊmˌsɪk>
monastery	mɑnæstərjaɪ	<ˈmɑnəˌstɛri>
unhelpful	ənhɛlpfəl	<ənˈhɛlpfəl>
standstill	stændstɪl	<ˈstændˌstɪl>
quake	kweɪk	<kweɪk>
transparency	trænzpɑrɛnkaɪ	<trænˈspɛrənsi>
shout	ʃaʊt	<ʃaʊt>
assemblage	æssɛmbleɪʤ	<əˈsɛmblɪʤ>
pensioner	pɛnsɪnər	<ˈpɛnʃənər>
redistributing	ridɪstrɪbətɪŋ	<ˌridɪˈstrɪbjətɪŋ>
precarious	prikɑraɪaʊz	<priˈkɛriəs>
ancestry	ænsɛstraɪ	<ˈænsɛstri>
labyrinth	læbjaɪrɪnθ	<ˈlæbərˌɪnθ>
situational	sɪtueɪtaɪnæl	<ˌsɪʧuˈeɪʃənəl>
dealing	dilɪŋ	<ˈdilɪŋ>
send	sɛnd	<sɛnd>
turnip	tərnɪp	<ˈtərnəp>
hopper	hɑppər	<ˈhɑpər>
magistrate	mægɪstreɪt	<ˈmæʤɪˌstreɪt>
teen	tin	<tin>
bloodline	bloʊdlaɪn	<ˈbləˌdlaɪn>
granny	grænnaɪ	<ˈgræni>
fresher	frɛʃər	<ˈfrɛʃər>
integrity	ɪntɛgraɪtaɪ	<ˌɪnˈtɛgrəti>
potent	poʊtɛnt	<ˈpoʊtənt>
cancerous	kænkəraʊz	<ˈkænsərəs>
complete	kɑmplit	<kəmˈplit>
watercolor	wɑtərkɑlər	<ˈwɔtərˌkələr>
meter	mitər	<ˈmitər>
stuffy	stəfjaɪ	<ˈstəfi>
jess	ʤɛs	<ʤɛs>
transcribe	trænskraɪb	<trænˈskraɪb>
enthusiasm	ɛnðusiæs	<ɪnˈθuziˌæzəm>
ale	eɪl	<eɪl>
citron	sɪtrɑn	<ˈsɪtrənz>
courage	kaʊəreɪʤ	<kərɪʤ>
bummer	bəmmɛr	<ˈbəmər>
gilt	gɪlt	<gɪlt>
legitimately	ligɪtaɪmeɪtlaɪ	<ləˈʤɪtəmətli>
stalk	stæk	<stɔk>
dossiers	dɑssiərs	<ˌdɔsˈjeɪz>
net	nɛt	<nɛt>
penchant	pɛnʧænt	<ˈpɛnʧənt>
satellite	sætɛllaɪt	<ˈsætəˌlaɪt>
metastasis	mitɑztɑsɪs	<məˈtæstəsɪs>
rectal	rɛktæl	<ˈrɛktəl>
silenced	silɛnt	<ˈsaɪlənst>
dogging	dɑgʤɪŋ	<ˈdɔgɪŋ>
medicated	mɛdaɪkætɛd	<ˈmɛdɪˌkeɪtɪd>
depravity	diprævaɪtaɪ	<dɪˈprævəti>
illuminator	ɪlluminɑtɔr	<ˌɪˈluməˌneɪtər>
spat	spæt	<spæt>
pamper	pæmpər	<ˈpæmpər>
baptismal	bæptɪsmæl	<bæpˈtɪzməl>
prototype	proʊtoʊtaɪp	<ˈproʊtoʊˌtaɪp>
semifinal	sɛmaɪfaɪnæl	<ˌsɛmɪˈfaɪnəl>
corneal	kɔrniæl	<ˌkɔrˈnil>
fibre	faɪbri	<ˈfaɪbər>
aptly	æptlaɪ	<ˈæptli>
imperfect	ɪmpərfɛkt	<ˌɪmˈpərfɪkt>
visit	vɪsɪt	<ˈvɪzɪt>
aggression	æggrɛssɪn	<əˈgrɛʃən>
jarring	ʤɑrrɪŋ	<ˈʤɑrɪŋ>
pinch	pɪnʧ	<pɪnʧ>
premises	prɛmɪsɛs	<ˈprɛməsəz>
traveler	trævɛlər	<ˈtrævələr>
seniority	sɛnjəraɪtaɪ	<sinˈjɔrɪti>
tunica	tunikɑ	<ˈtunɪkə>
yarn	jɑrn	<jɑrn>
streptococcus	strɛptoʊkɑkkəs	<ˌstrɛptəˈkɔkəs>
vibrate	vibreɪt	<ˈvaɪbreɪt>
polygon	pɑljaɪgɑn	<ˈpɑlɪˌgɑn>
impersonal	ɪmpərsɑnæl	<ˌɪmˈpərsənəl>
autoclave	oʊtoʊkleɪv	<ˈɔtoʊˌkleɪv>
from	frɑm	<frəm>
reset	risɛt	<ˈrisɛt>
colon	koʊlɑn	<ˈkoʊlən>
smithers	smɪθərs	<sˈmɪðərz>
plains	pleɪnz	<pleɪnz>
meaning	minɪŋ	<ˈminɪŋ>
fries	friz	<fraɪz>
ins	ɪns	<ˈaɪˈɛˈnɛs>
salaried	sæleɪrid	<ˈsælərid>
surveillance	sərvillæns	<sərˈveɪləns>
worried	wərrid	<ˈwərid>
engrave	ɛngreɪv	<ɪnˈgreɪv>
pixel	pɪksɛl	<ˈpɪksəl>
commissioner	kɑmmɪssɪnər	<kəˈmɪʃənər>
elastic	ilæstɪk	<ɪˈlæstɪk>
nationality	nɑtaɪnælaɪtaɪ	<ˌnæʃəˈnælɪti>
restrictive	ristrɪktaɪv	<riˈstrɪktɪv>
phrase	freɪz	<freɪz>
merida	mɛraɪdɑ	<mərˈidə>
totem	toʊtɛm	<ˈtoʊtəm>
aggressively	æggrɛssaɪvlaɪ	<əˈgrɛsɪvli>
blur	blər	<blər>
winter	wɪntər	<ˈwɪntər>
stabilization	stɑbaɪlaɪzɑtaɪn	<ˌsteɪbələˈzeɪʃən>
disintegration	dɪsɪntigrætaɪn	<dɪˌsɪnəˈgreɪʃən>
insolvent	ɪnsɑlvɛnt	<ˌɪnˈsɑlvənt>
definitively	difɪnaɪtaɪvlaɪ	<dɪˈfɪnɪtɪvli>
tube	tub	<tub>
yearn	jərn	<jərn>
crass	kræs	<kræs>
metabolic	mɛteɪbɑlɪk	<ˌmɛtəˈbɑlɪk>
arrive	ɑrraɪv	<əraɪv>
decadent	dɛkeɪdɛnt	<ˈdɛkədənt>
inoculation	ɪnɑkulɑtaɪn	<ˌɪˌnɑkjəˈleɪʃən>
abba	æbbɑ	<ˈæbə>
curiously	kuraɪaʊzlaɪ	<ˈkjʊriəsli>
jackpot	ʤækpɑt	<ˈʤækˌpɑt>
ruckus	rəkəs	<ˈrəkəs>
springboard	spɪŋbɔrd	<ˈsprɪŋˌbɔrd>
pretentious	pritɛntaʊz	<priˈtɛnʃəs>
reverend	rɛvərɛnd	<ˈrɛvərənd>
thickness	θɪknɛs	<ˈθɪknəs>
glove	gloʊv	<gləv>
lactation	læktɑtaɪn	<lækˈteɪʃən>
proprietor	proʊpraɪitɔr	<prəˈpraɪətər>
smelly	smɛljaɪ	<sˈmɛli>
profane	proʊfeɪn	<proʊˈfeɪn>
aphrodisiac	æfroʊdɪsaɪæk	<ˌæfroʊˈdiziæk>
arraignment	ɑrreɪnmɛnt	<ərˈeɪnmənt>
wizardry	wɪzɑrdraɪ	<ˈwɪzərdri>
proportioned	proʊpɔrtaɪnd	<prəˈpɔrʃənd>
naturally	næturællaɪ	<ˈnæʧərəli>
scholar	skɑlɑr	<ˈskɑlər>
swig	sɪg	<swɪg>
rediscover	ridɪskɑvər	<ridɪˈskəvər>
banner	bænnɛr	<ˈbænər>
avian	eɪviæn	<ˈeɪviən>
anabolic	æneɪbɑlɪk	<ˌænəˈbɑlɪk>
vodka	vɑdkɑ	<ˈvɑdkə>
reclassification	riklæssifaɪkɑtaɪn	<riˌklæsəfəˈkeɪʃən>
rut	rut	<rət>
complainant	kɑmpleɪnænt	<kəmˈpleɪnənt>
asserted	æssərtɛd	<əˈsərtəd>
roomy	rumjaɪ	<ˈrumi>
harrow	hɑrroʊ	<ˈhæroʊ>
completeness	kɑmplitnɛs	<kəmˈplitnəs>
postcard	pɑstkɑrd	<ˈpoʊˌskɑrd>
extended	ɛkstɛndɛd	<ɪkˈstɛndɪd>
choking	ʧɑkɪŋ	<ˈʧoʊkɪŋ>
climate	klaɪmeɪt	<ˈklaɪmɪt>
sitter	sɪttər	<ˈsɪtər>
gallery	gællərjaɪ	<ˈgæləri>
antifungal	æntifəngæl	<ˌænˌtiˈfəŋgəl>
shun	ʃən	<ʃən>
designated	dɛsɪgnætɛd	<ˈdɛzɪgˌneɪtɪd>
accelerating	æksɛlərætɪŋ	<ækˈsɛlərˌeɪtɪŋ>
poss	pɑs	<pɔs>
religiously	rilaɪgaʊzlaɪ	<rɪˈlɪʤəsli>
broth	broʊθ	<brɔθ>
moulin	mulɪn	<muˈlæn>
libido	laɪbaɪdoʊ	<ləˈbaɪˌdoʊ>
cruising	kruzɪŋ	<ˈkruzɪŋ>
serial	siraɪæl	<ˈsɪˌriəl>
stability	stɑbɪlaɪtaɪ	<stəˈbɪlɪti>
elucidate	ilukideɪt	<ɪˈlusəˌdeɪt>
recordable	rikɔrdeɪbli	<rɪˈkɔrdəbəl>
mucus	mukəs	<mˈjukəs>
pippin	pɪppɪn	<ˈpɪpɪn>
per	pər	<pər>
overlapping	oʊvərlæppɪŋ	<ˈoʊvərˌlæpɪŋ>
inspire	ɪnspaɪr	<ˌɪnˈspaɪr>
yoga	jɑgɑ	<ˈjoʊgə>
parenthood	pɑrɛnthʊd	<ˈpɛrənˌthʊd>
desired	disaɪrd	<dɪˈzaɪərd>
retrospect	rɛtroʊspɛkt	<ˈrɛtrəˌspɛkt>
restored	ristɔrd	<rɪˈstɔrd>
precisely	prisaɪzlaɪ	<prɪˈsaɪsli>
skillfully	skɪlfəllaɪ	<ˈskɪlfəli>
keno	kinoʊ	<ˈkinoʊ>
midway	mɪdweɪ	<ˈmɪdˌweɪ>
renin	rinɪn	<ˈrinən>
resuscitation	risəskitɑtaɪn	<rɪˌsəsɪˈteɪʃən>
feathers	fiθərs	<ˈfɛðərz>
weathered	wiθɛrd	<ˈwɛðərd>
division	daɪvisɪn	<dɪˈvɪʒən>
appealing	æppilɪŋ	<əˈpilɪŋ>
throughput	θrəfpʊt	<θˈruˌpʊt>
obscurity	ɑbskuraɪtaɪ	<əbˈskjʊrəti>
constellation	kɑnstɛllɑtaɪn	<ˌkɑnstəˈleɪʃən>
profiled	proʊfaɪld	<ˈproʊˌfaɪld>
scripture	skrɪptʊr	<ˈskrɪpʧər>
retailer	riteɪlər	<ˈriˌteɪlər>
grains	greɪnz	<greɪnz>
greasy	grizjaɪ	<ˈgrisi>
encephalitis	ɛnʧɛfeɪlaɪtɪs	<ɛnˌsɛfəˈlaɪtəs>
quandary	kwɑndɑraɪ	<kˈwɑndəri>
astute	æstut	<əˈstut>
control	kɑntrɑl	<kənˈtroʊl>
developer	divɛlɑpər	<dɪˈvɛləpər>
repurchase	ripərʧeɪz	<riˈpərʧəs>
principled	prɪnkiplɛd	<ˈprɪnsəpəld>
return	ritərn	<rɪˈtərn>
crazed	kreɪzd	<kreɪzd>
parallax	pɑrællæks	<ˈpɛrəˌlæks>
appreciable	æpprikieɪbli	<əˈpriʃəbəl>
leviathan	livieɪθɑn	<lɛˈvaɪəθən>
decomposed	dikɑmpoʊzd	<ˌdikəmˈpoʊzd>
disclaim	dɪskleɪm	<dɪˈskleɪm>
persevere	pərsivɪr	<pərsəˈvɪr>
recruitment	rikrutmɛnt	<rɪˈkrutmənt>
platform	plætfɔrm	<ˈplætˌfɔrm>
consistently	kɑnsɪstɛntlaɪ	<kənˈsɪstəntli>
arm	ɑrm	<ɑrm>
blender	blɛndər	<ˈblɛndər>
outlier	aʊtlaɪər	<ˈaʊtlaɪər>
mutt	mət	<mət>
molly	mɑllaɪ	<ˈmɑli>
fishing	fɪʃɪŋ	<ˈfɪʃɪŋ>
rhododendron	roʊdoʊdɛndrɑn	<ˌroʊdəˈdɛndrən>
deliverance	dilɪvəræns	<dɪˈlɪvərəns>
vanguard	vængɑrd	<ˈvænˌgɑrd>
caseload	keɪzloʊd	<ˈkeɪsˌloʊd>
feeder	fidər	<ˈfidər>
hope	hoʊp	<hoʊp>
occasions	ɑkkɑsaɪnz	<ɔˈkeɪʒənz>
indulgent	ɪndəlʤɛnt	<ˌɪnˈdəlʤənt>
lexical	lɛksaɪkæl	<ˈlɛksɪkəl>
peculiarly	pikulɪrlaɪ	<pɪˈkjuljərli>
exam	ɛksæm	<ɪgˈzæm>
enhancer	ɛnhænkər	<ɛnˈhænsər>
iman	aɪmæn	<ˈaɪmən>
wretched	rɛʧɛd	<ˈrɛʧɪd>
diabetic	daɪeɪbɛtɪk	<ˌdaɪəˈbɛtɪk>
gosh	gɑʃ	<gɑʃ>
please	pliz	<pliz>
extremism	ɛkstrɛmɪs	<ˌɪkˈstrɛmɪzəm>
feature	fitʊr	<ˈfiʧər>
forbidding	fɔrbɪddɪŋ	<fərˈbɪdɪŋ>
blinks	blɪŋks	<blɪŋks>
der	dər	<dər>
biological	baɪoʊlɑgaɪkæl	<ˌbaɪəˈlɑʤɪkəl>
surat	suræt	<sərɑt>
renaissance	rineɪzsæns	<ˌrɛnəˈsɑns>
segregated	sɛgrigætɛd	<ˈsɛgrəˌgeɪtɪd>
graft	græft	<græft>
journalism	ʤʊrnælɪs	<ˈʤərnəˌlɪzəm>
seventeenth	sɛvɛntinθ	<ˈsɛvənˈtinθ>
cardiovascular	kɑrdaɪoʊvæskulɑr	<ˌkɑrdioʊˈvæskjələr>
countryman	kaʊntraɪmæn	<ˈkəntrimən>
interwoven	ɪntərwoʊvɛn	<ˌɪntərˈwoʊvən>
prevent	privɛnt	<prɪˈvɛnt>
crockery	krɑkərjaɪ	<ˈkrɑkəri>
pissing	pɪsɪŋ	<ˈpɪˌsɪŋ>
rusty	rəstjaɪ	<ˈrəsti>
tropical	trɑpaɪkæl	<ˈtrɑpɪkəl>
consul	kɑnsəl	<ˈkɑnsəl>
stemming	stɛmmɪŋ	<ˈstɛmɪŋ>
bookseller	bʊksɛllər	<ˈbʊkˌsɛlər>
och	ɑʧ	<ɑk>
proviso	proʊvisoʊ	<prəˈvaɪzoʊ>
nuisance	nusæns	<ˈnusəns>
daughter	dɔftər	<ˈdɔtər>
scat	skæt	<skæt>
castor	kæstɔr	<ˈkæstər>
clipping	klɪppɪŋ	<ˈklɪpɪŋ>
torque	tɔrk	<tɔrk>
landscaped	lændskeɪpt	<ˈlændˌskeɪpt>
organized	ərgænaɪzd	<ˈɔrgəˌnaɪzd>
sucre	sukri	<ˈsukər>
des	dɛs	<dɪ>
retroactive	rɛtroʊæktaɪv	<ˌrɛtroʊˈæktɪv>
utilization	utilaɪzɑtaɪn	<ˌjutələˈzeɪʃən>
spinal	spaɪnæl	<ˈspaɪnəl>
heinous	heɪnuz	<ˈheɪnəs>
excavator	ɛkskɑvɑtɔr	<ˈɛkskəˌveɪtər>
fuzzy	fəzjaɪ	<ˈfəzi>
clarinet	klɑraɪnɛt	<ˌklɛrəˈnɛt>
formal	fɔrmæl	<ˈfɔrməl>
ventilation	vɛntilɑtaɪn	<ˌvɛntɪˈleɪʃən>
newsworthy	nuzwərðaɪ	<ˈnuzˌwərði>
inertia	ɪnərtaɪ	<ˌɪˈnərʃə>
presidency	prɛzaɪdɛnkaɪ	<ˈprɛzɪdənsi>
irrigated	ərraɪgætɛd	<ˈɪrəˌgeɪtɪd>
locomotive	loʊkoʊmoʊtaɪv	<ˌloʊkəˈmoʊtɪv>
speechless	spiʧlɛs	<ˈspiʧləs>
making	mækɪŋ	<ˈmeɪkɪŋ>
proton	proʊtɑn	<ˈproʊˌtɑn>
multitude	məltitud	<ˈməltəˌtud>
implicit	ɪmplɪkɪt	<ˌɪmˈplɪsət>
punter	pəntər	<ˈpəntər>
esker	ɛskər	<ˈɛskər>
geyser	geɪsər	<ˈgaɪzər>
literature	lɪtəreɪtʊr	<ˈlɪtərəʧər>
binoculars	bɪnɑkulɑrz	<bəˈnɑkjələrz>
inefficiency	ɪnɛffaɪsinkaɪ	<ˌɪnɪˈfɪʃənsi>
refrigeration	rifrɪgəreɪtaɪn	<rɪˌfrɪʤərˈeɪʃən>
reggae	rɛggeɪ	<ˈrɛˌgeɪ>
gratefully	greɪtfəllaɪ	<ˈgreɪtfəli>
rectangle	rɛktængli	<ˈrɛktæŋgəl>
swear	swɪr	<swɛr>
hasty	hæstjaɪ	<ˈheɪsti>
swallow	swɑlloʊ	<sˈwɔloʊ>
mambo	mæmboʊ	<ˈmɑmboʊ>
tabulated	tæbulætɛd	<ˈtæbjəˌleɪtɪd>
marc	mɑrk	<mɑrk>
fifty	fɪftaɪ	<ˈfɪfti>
beggar	bɛggɑr	<ˈbɛgər>
scallop	skællɑp	<ˈskæləp>
forte	fɔrt	<ˈfɔrteɪ>
winery	wɪnərjaɪ	<ˈwaɪnəri>
cocker	kɑkər	<ˈkɑkər>
device	divaɪs	<dɪˈvaɪs>
entertaining	ɛntərteɪnɪŋ	<ˌɛnərˈteɪnɪŋ>
wan	wɑn	<wɑn>
horizontal	həraɪzɑntæl	<ˌhɔrəˈzɑntəl>
tong	tɑŋ	<tɔŋ>
intensify	ɪntɛnsifaɪ	<ˌɪnˈtɛnsɪˌfaɪ>
steal	stil	<stil>
passable	pæseɪbli	<ˈpæsəbəl>
below	biloʊ	<bɪˈloʊ>
ensured	ɛnsjʊrd	<ɪnˈʃʊrd>
dropper	drɑppər	<ˈdrɑpər>
deputy	dɛputaɪ	<ˈdɛpjəti>
hight	haɪt	<haɪt>
ravel	rævɛl	<ˈrævəl>
protecting	proʊtɛktɪŋ	<prəˈtɛktɪŋ>
respect	rispɛkt	<rɪˈspɛkt>
lute	lut	<lut>
triplex	traɪplɛks	<trɪˈplɛks>
examine	ɛksæmaɪn	<ɪgˈzæmɪn>
dome	doʊm	<doʊm>
graduated	græduætɛd	<ˈgræʤəˌweɪtɪd>
gondola	gɑndoʊlɑ	<ˈgɑndələ>
faceted	fækɛtɛd	<ˈfæsətɪd>
benign	binɪŋ	<bɪˈnaɪn>
normalized	nɔrmælaɪzd	<ˈnɔrməˌlaɪzd>
declaration	dɛklɑrɑtaɪn	<ˌdɛklərˈeɪʃən>
watchdog	wɑʧdɑg	<ˈwɑʧˌdɔg>
forestry	fɔrɛstraɪ	<ˈfɔrəstri>
mineralogy	mɪnəræloʊgaɪ	<ˌmɪnərˈɑləʤi>
epidermis	ɛpaɪdərmɪs	<ˌɛpɪˈdərməs>
syntax	sɪntæks	<ˈsɪnˌtæks>
needs	nidz	<nidz>
printer	prɪntər	<ˈprɪnər>
crush	krəʃ	<krəʃ>
bulletin	bəllitɪn	<ˈbʊlɪtən>
reseller	risɛlər	<riˈsɛlər>
dissection	dɪssɛktaɪn	<ˈdaɪsɛkʃən>
gradation	grædɑtaɪn	<greɪˈdeɪʃən>
expectant	ɛkspɛktænt	<ɪkˈspɛktənt>
blouse	blaʊs	<blaʊs>
vegetarianism	vɛgitɑraɪænɪs	<ˌvɛʤəˈtɛˌriəˌnɪzəm>
passing	pæsɪŋ	<ˈpæsɪŋ>
mobilize	moʊbaɪlaɪz	<ˈmoʊbəˌlaɪz>
alternative	æltərnɑtaɪv	<ɔlˈtərnətɪv>
history	hɪstoʊraɪ	<ˈhɪstəri>
discriminatory	dɪskrɪmaɪnɑtoʊraɪ	<dɪˈskrɪmənəˌtɔri>
owing	oʊɪŋ	<oʊɪŋ>
mosque	mɑsk	<mɔsk>
instinctively	ɪnstɪntaɪvlaɪ	<ˌɪnˈstɪŋktɪvˌli>
dealership	dilərʃɪp	<ˈdilərˌʃɪp>
colleen	kɑllin	<ˌkɑˈlin>
cot	kɑt	<kɑt>
auditorium	oʊdaɪtoʊraɪəm	<ˌɔdəˈtɔriəm>
larkspur	lɑrkspər	<ˈlɑrkˌspər>
maniac	mɑniæk	<ˈmeɪniˌæk>
carburetor	kɑrburitɔr	<ˈkɑrbərˌeɪtər>
suicidal	suaɪsɪdæl	<ˌsuəˈsaɪdəl>
illuminate	ɪllumineɪt	<ˌɪˈlumɪnɪt>
carmel	kɑrmɛl	<ˈkɑrməl>
kang	kæŋ	<kɑŋ>
inset	ɪnsɛt	<ˈɪnˌsɛt>
shalt	ʃælt	<ʃælt>
entirety	ɛntaɪərtaɪ	<ɪnˈtaɪərti>
nostalgia	nɑstælgaɪ	<nɔˈstælʤə>
deterministic	ditərmɪnɪstɪk	<dɪˌtərməˈnɪstɪk>
rug	rəg	<rəg>
deleterious	dɛlitiraɪaʊz	<ˌdɛləˈtɪriəs>
lucifer	lukifər	<ˈlusəfər>
grandpa	grændpɑ	<ˈgrændˌpɑ>
myself	maɪsɛlf	<ˌmaɪˈsɛlf>
nevermore	nɛvərmɔr	<ˈnɛvərˌmɔr>
instruct	ɪnstərst	<ˌɪnˈstrəkt>
essence	ɛssɛns	<ˈɛsəns>
fiancee	faɪænsi	<fiˈænsi>
follicle	fɑllaɪkli	<ˈfɑlɪkəl>
fairies	fɛraɪz	<ˈfɛriz>
bach	bæʧ	<bɑk>
anger	ængər	<ˈæŋgər>
fission	fɪssɪn	<ˈfɪʃən>
homework	hoʊmwərk	<ˈhoʊmˌwərk>
glassware	glæswɛr	<ˈglæsˌwɛr>
intonation	ɪntoʊnɑtaɪn	<ˌɪntəˈneɪʃən>
aide	eɪd	<eɪd>
legislation	lɛgɪslɑtaɪn	<ˌlɛʤəsˈleɪʃən>
zest	zɛst	<zɛst>
disaster	dɪsæstər	<dɪˈzæstər>
trampoline	træmpoʊlaɪn	<ˌtræmpəˈlin>
boardwalk	bɔrdwɔk	<ˈbɔrdˌwɔk>
shrug	ʃrəg	<ʃrəg>
each	iʧ	<iʧ>
blurry	blərraɪ	<ˈbləri>
underwater	əndərwɑtər	<ˈəndərˌwɔtər>
regardless	rigɑrdlɛs	<rəˈgɑrdləs>
mezzo	mɛzzoʊ	<ˈmɛzoʊ>
mode	moʊd	<moʊd>
pansy	pænsaɪ	<ˈpænzi>
caving	kævɪŋ	<ˈkeɪvɪŋ>
gourmet	gaʊrmɛt	<ˈgʊrˌmeɪ>
contribute	kɑntrɪbjut	<kənˈtrɪbjut>
dole	doʊl	<doʊl>
sterilized	stɛraɪlaɪzd	<ˈstɛrəˌlaɪzd>
engaged	ɛngeɪʤd	<ɪnˈgeɪʤd>
completion	kɑmplitaɪn	<kəmˈpliʃən>
revenge	rivɛnʤ	<riˈvɛnʤ>
heretofore	hɛrtoʊfɔr	<ˌhɪrtəˈfɔr>
abnormal	æbnɔrmæl	<æbˈnɔrməl>
conservator	kɑnsərvɑtɔr	<kənˈsərvətər>
tony	tɑnjaɪ	<ˈtoʊni>
distraction	dɪstræktaɪn	<dɪˈstrækʃən>
catch	kæʧ	<kæʧ>
sampling	sæmpɪŋ	<ˈsæmplɪŋ>
unverified	ənvəraɪfaɪd	<ənˈvɛrɪˌfaɪd>
exec	ɛks	<ˌɛgˈzɛk>
fill	fɪl	<fɪl>
clump	kləmp	<kləmp>
germanic	gərmænɪk	<ʤərˈmænɪk>
coastline	koʊstlaɪn	<ˈkoʊˌstlaɪn>
adaptive	eɪdæptaɪv	<əˈdæptɪv>
berry	bərraɪ	<ˈbɛri>
decorated	dɛkoʊrætɛd	<ˈdɛkərˌeɪtɪd>
manipulate	mɑnɪpuleɪt	<məˈnɪpjəˌleɪt>
don	dɑn	<dɑn>
messier	mɛsaɪər	<ˈmɛsiər>
telephony	tilɛfoʊnaɪ	<ˈtɛləˌfoʊni>
arouse	eɪraʊz	<əraʊz>
appendixes	æppɛndɪksɛs	<əˈpɛndɪksɪz>
sep	sɛp	<ˈɛˈsiˈpi>
clothes	kloʊð	<kloʊðz>
diversion	daɪvərsɪn	<dɪˈvərʒən>
certification	kərtifaɪkɑtaɪn	<ˌsərtəfəˈkeɪʃən>
infancy	ɪnfænkaɪ	<ˈɪnfənsi>
footing	futɪŋ	<ˈfʊtɪŋ>
reorganization	riərgænaɪzɑtaɪn	<ˌriɔrgənəˈzeɪʃən>
citation	kitɑtaɪn	<saɪˈteɪʃən>
amply	æmplaɪ	<ˈæmpli>
jai	ʤeɪ	<ʤaɪ>
stifle	staɪfli	<ˈstaɪfəl>
desolation	dɛsoʊlɑtaɪn	<ˌdɛsəˈleɪʃən>
peeling	pilɪŋ	<ˈpilɪŋ>
breweries	bruəraɪz	<ˈbruəriz>
paradise	pɑreɪdaɪz	<ˈpɛrəˌdaɪs>
lousy	laʊzjaɪ	<ˈlaʊzi>
invertebrate	ɪnvərtibreɪt	<ˌɪnˈvərtəˌbreɪt>
provincial	proʊvɪnkil	<prəˈvɪnʃəl>
midwifery	mɪdwaɪfraɪ	<ˈmɪdˌwaɪfəri>
inhale	ɪnheɪl	<ˌɪnˈheɪl>
emulated	ɛmulætɛd	<ˈɛmjəˌleɪtɪd>
recurrence	rikərrɛns	<rɪˈkərəns>
hostility	hɑstɪlaɪtaɪ	<hɑˈstɪləti>
flatness	flætnɛs	<ˈflætnəs>
collide	kɑllaɪd	<kəˈlaɪd>
protest	proʊtɛst	<ˈproʊˌtɛst>
tufted	təftɛd	<ˈtəftɪd>
rudimentary	rudaɪmɛntɑraɪ	<ˌrudəˈmɛntəri>
put	pʊt	<pʊt>
quantitatively	kwɑntitɑtaɪvlaɪ	<kˌwɑntɪˈteɪtəvli>
laden	lædɛn	<ˈleɪdən>
perspective	pərspɛktaɪv	<pərˈspɛktɪv>
unqualified	ənkwɑlaɪfaɪd	<ənkˈwɑlɪˌfaɪd>
dimmer	dɪmmɛr	<ˈdɪmər>
medico	mɛdaɪkoʊ	<ˈmɛdɪˌkoʊ>
montes	mɑntɛs	<ˈmɑntɛz>
surprising	sərprɪsɪŋ	<səˈpraɪzɪŋ>
wilder	wɪldər	<ˈwaɪldər>
succinct	səksɪnt	<səkˈsɪŋkt>
expenditure	ɛkspɛndaɪtʊr	<ɪkˈspɛndɪʧər>
piety	paɪitaɪ	<ˈpaɪəti>
give	gɪv	<gɪv>
con	kɑn	<kɑn>
beastie	bistaɪ	<ˈbisti>
serialize	siraɪælaɪz	<ˈsɪˌriəˌlaɪz>
industrial	ɪndəstraɪæl	<ˌɪnˈdəstriəl>
suds	sədz	<sədz>
morphine	mɔrfaɪn	<ˈmɔrfin>
bankroll	bæŋkroʊl	<ˈbæŋˌkroʊl>
flags	flægz	<flægz>
geek	ʤik	<gik>
pool	pul	<pul>
sym	sɪm	<sɪm>
catcher	kæʧər	<ˈkæˌʧər>
arcana	ɑrkɑnɑ	<ɑrˈkænə>
balboa	bælboʊeɪ	<bɑlˈboʊə>
jojoba	ʤoʊʤoʊbɑ	<hoʊˈhoʊbə>
undergo	əndərgoʊ	<ˌəndərˈgoʊ>
poser	pɑsər	<ˈpoʊzər>
puppet	pʊppɛt	<ˈpəpɪt>
bison	baɪsɑn	<ˈbaɪsən>
state	steɪt	<steɪt>
invocation	ɪnvoʊkɑtaɪn	<ˌɪnvəˈkeɪʃən>
manly	mænlaɪ	<ˈmænli>
ammonium	æmmoʊniəm	<əˈmoʊniəm>
hyacinth	haɪeɪnɪnθ	<ˈhaɪəˌsɪnθ>
civic	kɪvɪk	<ˈsɪvɪk>
contingency	kɑntɪnʤɛnkaɪ	<kənˈtɪnʤənsi>
guild	gɪld	<gɪld>
unequivocally	ənikwɪvoʊkællaɪ	<ˌənikˈwɪvəkəli>
cherish	ʧɛrɪʃ	<ˈʧɛrɪʃ>
filip	fɪlɪp	<ˈfɪlɪp>
freeway	friweɪ	<ˈfriˌweɪ>
scratchy	skræʧjaɪ	<ˈskræʧi>
compressed	kɑmprɛst	<kəmˈprɛst>
carbohydrate	kɑrboʊhaɪdreɪt	<ˌkɑrboʊˈhaɪˌdreɪt>
quill	kwɪl	<kwɪl>
synoptic	sɪnɑptɪk	<sɪˈnɑptɪk>
dentist	dɛntɪst	<ˈdɛntɪst>
pedagogy	pɛdeɪgoʊgaɪ	<ˈpɛdəˌgoʊʤi>
hover	hɑvər	<ˈhəvər>
chassis	ʧɑzsɪs	<ˈʧæsi>
alpaca	ælpækeɪ	<ælˈpækə>
choreography	ʧoʊriɑgrɑfaɪ	<ˌkɔriˈɑgrəfi>
denied	dinid	<dɪˈnaɪd>
cynic	kɪnɪk	<ˈsɪnɪk>
lead	lid	<lɛd>
rigid	rɪgɪd	<ˈrɪʤɪd>
northerly	nɔrθərlaɪ	<ˈnɔrðərli>
between	bitwin	<bɪtˈwin>
assume	æssum	<əˈsum>
satisfy	sætɪsfaɪ	<ˈsætɪsˌfaɪ>
welt	wɛlt	<wɛlt>
yardstick	jɑrdstɪk	<ˈjɑrdˌstɪk>
bye	baɪ	<baɪ>
secretarial	sɛkritɑraɪæl	<ˌsɛkrəˈtɛriəl>
fart	fɑrt	<fɑrt>
roost	rust	<rust>
pickwick	pɪkwɪk	<ˈpɪkˌwɪk>
mahatma	mɑhætmɑ	<məˈhɑtmə>
tennis	tɛnnɪs	<ˈtɛnɪs>
predicament	pridɪkeɪmɛnt	<prɪˈdɪkəmənt>
stokes	stoʊks	<stoʊks>
usher	əʃər	<ˈəʃər>
continuation	kɑntɪnueɪtaɪn	<kənˌtɪnjuˈeɪʃən>
ritter	rɪttər	<ˈrɪtər>
pain	peɪn	<peɪn>
distant	dɪstænt	<ˈdɪstənt>
centurion	sɛnturaɪɑn	<sɛnˈtʊriən>
defence	difɛns	<dɪˈfɛns>
shutter	ʃuttər	<ˈʃətər>
eel	il	<il>
indistinguishable	ɪndɪstɪngɪʃeɪbli	<ˌɪndɪˈstɪŋgwɪʃəbəl>
anticipated	æntɪkaɪpætɛd	<ænˈtɪsəˌpeɪtɪd>
arrears	ɑrrɪrz	<ərɪrz>
walk	wɔk	<wɔk>
mourn	mɔrn	<mɔrn>
viable	vieɪbli	<ˈvaɪəbəl>
chowder	ʧoʊdər	<ˈʧaʊdər>
inspiration	ɪnspaɪrɑtaɪn	<ˌɪnspərˈeɪʃən>
biweekly	baɪwiklaɪ	<baɪˈwikli>
fame	feɪm	<feɪm>
trapeze	trɑpiz	<trəˈpiz>
scramble	skræmbli	<ˈskræmbəl>
invite	ɪnvaɪt	<ˌɪnˈvaɪt>
twill	tɪl	<twɪl>
foiled	fɔɪld	<fɔɪld>
subtle	səbti	<ˈsətəl>
editorial	ɛdaɪtoʊraɪæl	<ˌɛdəˈtɔriəl>
zoological	zoʊoʊlɑgaɪkæl	<ˌzuˈlɑʤɪkəl>
diamond	daɪmɑnd	<ˈdaɪmənd>
infield	ɪnfild	<ˈɪnˌfild>
charade	ʧɑreɪd	<ʃəreɪd>
whiff	wɪf	<wɪf>
specialization	spikilaɪzɑtaɪn	<ˌspɛʃələˈzeɪʃən>
vise	vaɪz	<vaɪs>
iconography	aɪkoʊnɑgrɑfaɪ	<ˌaɪkəˈnɑgrəfi>
twice	twaɪs	<twaɪs>
popular	pɑpulɑr	<ˈpɑpjələr>
address	æddrɛs	<ˈæˌdrɛs>
extravagance	ɛkstræveɪgæns	<ɛkˈstrævəgəns>
goat	goʊt	<goʊt>
cords	kɔrdz	<kɔrdz>
notions	noʊtaɪnz	<ˈnoʊʃənz>
scarcely	skɑrslaɪ	<ˈskɛrsli>
impair	ɪmpɛr	<ˌɪmˈpɛr>
winning	wɪnnɪŋ	<ˈwɪnɪŋ>
promulgate	prɑməlgeɪt	<proʊˈməlgeɪt>
better	bɛttər	<ˈbɛtər>
myth	mɪθ	<mɪθ>
customary	kəstɑmɑrjaɪ	<ˈkəstəˌmɛri>
deeply	diplaɪ	<ˈdipli>
condensate	kɑndɛnseɪt	<ˈkɑndənˌseɪt>
weave	wiv	<wiv>
miscarriage	mɪskɑrreɪʤ	<mɪˈskɛrəʤ>
dueling	duɛlɪŋ	<ˈdulɪŋ>
mesmerizing	mɛsmɛrɪzɪŋ	<ˈmɛzmərˌaɪzɪŋ>
arctic	ɑrktɪk	<ˈɑrtɪk>
whine	waɪn	<waɪn>
indiscriminate	ɪndɪskrɪmaɪneɪt	<ˌɪndɪˈskrɪmənət>
you	ju	<ju>
cribbage	krɪbbeɪʤ	<ˈkrɪbəʤ>
cozy	koʊzaɪ	<ˈkoʊzi>
tew	tu	<tu>
loca	loʊkɑ	<ˈloʊkə>
accompanied	ækkɑmpɑnid	<əˈkəmpənid>
ignored	ɪgnɔrd	<ˌɪgˈnɔrd>
atmospheric	ætmɑsfɛrɪk	<ˌætməsˈfɛrɪk>
prosecuting	prɑsikutɪŋ	<ˈprɑsɪˌkjutɪŋ>
assertive	æssərtaɪv	<əˈsərtɪv>
undermine	əndərmaɪn	<ˈəndərˌmaɪn>
carlin	kɑrlɪn	<ˈkɑrlɪn>
hopeless	hoʊplɛs	<ˈhoʊpləs>
bookie	bʊkaɪ	<ˈbʊki>
wuthering	wuθərɪŋ	<ˈwəðərɪŋ>
judicious	ʤudaɪkaʊz	<ʤuˈdɪʃəs>
watchman	wɑʧmæn	<ˈwɑʧmən>
conjugate	kɑnʤugeɪt	<ˌkɑnʤəˈgeɪt>
comp	kɑmp	<kɑmp>
lode	loʊd	<loʊd>
speedy	spidjaɪ	<ˈspiˌdi>
plunger	pləŋər	<ˈplənʤər>
callous	kællaʊz	<ˈkæləs>
triglyceride	traɪglɪkəraɪd	<traɪˈglɪsərˌaɪd>
payable	peɪeɪbli	<ˈpeɪəbəl>
farrow	fɑrroʊ	<ˈfɛˌroʊ>
merciless	mɛrkilɛs	<ˈmərsələs>
hypothermia	haɪpoʊθərmieɪ	<ˌhaɪpəˈθərmiə>
sampler	sæmplər	<ˈsæmplər>
brokerage	broʊkəreɪʤ	<ˈbroʊkərɪʤ>
snappy	snæppaɪ	<sˈnæpi>
inhabited	ɪnhɑbɪtɛd	<ˌɪnˈhæbətəd>
criminally	krɪmaɪnællaɪ	<ˈkrɪmənəli>
welcome	wɛlkoʊm	<ˈwɛlkəm>
rheumatology	rumɑtɑloʊgaɪ	<ˌruməˈtɑləʤi>
reactor	riæktɔr	<riˈæktər>
beset	bisɛt	<bɪˈsɛt>
lag	læg	<læg>
fanaticism	fɑnætaɪkɪs	<fəˈnætəˌsɪzəm>
pose	poʊz	<poʊz>
panel	pænɛl	<ˈpænəl>
hoary	hɔrjaɪ	<ˈhɔri>
dom	dɑm	<dɑm>
interdependence	ɪntərdipɛndɛns	<ˌɪntərdəˈpɛndəns>
sleek	slik	<slik>
monograph	mɑnoʊgræf	<ˈmɑnəˌgræf>
amorous	æmoʊraʊz	<ˈæmərəs>
lop	lɑp	<lɑp>
assortment	æssɔrtmɛnt	<əˈsɔrtmənt>
tribal	trɪbæl	<ˈtraɪbəl>
follower	fɑlloʊər	<ˈfɑloʊər>
rem	rɛm	<rɛm>
impure	ɪmpʊr	<ˌɪmˈpjʊr>
parry	pɑrraɪ	<ˈpɛri>
attributing	ættrɪbətɪŋ	<əˈtrɪbjətɪŋ>
slack	slæk	<slæk>
icy	aɪkaɪ	<ˈaɪsi>
strain	streɪn	<streɪn>
aloft	eɪlɑft	<əˈlɔft>
instruction	ɪnstrəktaɪn	<ˌɪnˈstrəkʃən>
flung	fləŋ	<fləŋ>
budge	bəʤ	<bəʤ>
justice	ʤəstaɪs	<ˈʤəstɪs>
capitalize	kæpaɪtælaɪz	<ˈkæpətəˌlaɪz>
salamander	sæleɪmændər	<ˌsæləˈmændər>
observer	ɑbsərvər	<əbˈzərvər>
sprinkle	sprɪnklu	<ˈsprɪŋkəl>
reproach	riprɑʧ	<riˈproʊʧ>
parsing	pɑrzɪŋ	<ˈpɑrsɪŋ>
redefinition	ridɛfaɪnitaɪn	<riˌdɛfəˈnɪʃən>
lar	lɑr	<lɑr>
cavendish	kævɛndɪʃ	<ˈkævəndɪʃ>
improbable	ɪmprɑbeɪbli	<ˌɪmˈprɑbəbəl>
brad	bræd	<bræd>
intensified	ɪntɛnsifaɪd	<ˌɪnˈtɛnsɪˌfaɪd>
mistrust	mɪstrəst	<mɪˈstrəst>
ripe	raɪp	<raɪp>
became	bikeɪm	<bɪˈkeɪm>
corrie	kɔrraɪ	<ˈkɔri>
ferrous	fərraʊz	<ˈfɛrəs>
quoting	kwɑtɪŋ	<kˈwoʊtɪŋ>
uniformed	unifɔrmd	<ˈjunəˌfɔrmd>
manufacture	mænufæktʊr	<ˌmænjəˈfækʧər>
washing	wɑʃɪŋ	<ˈwɑʃɪŋ>
hobbyist	hɑbbaɪɪst	<ˈhɑbiɪst>
coin	kɔɪn	<kɔɪn>
arroyo	ɑrrɔɪoʊ	<ərɔɪoʊ>
rallied	rællaɪd	<ˈrælid>
dimer	daɪmɛr	<ˈdaɪmər>
aberration	æbərrɑtaɪn	<ˌæbərˈeɪʃən>
arguing	ɑrguɪŋ	<ˈɑrgjuɪŋ>
reactionary	riæktaɪnɑrjaɪ	<riˈækʃəˌnɛri>
drumming	drəmmɪŋ	<ˈdrəmɪŋ>
bagpipe	bægpaɪp	<ˈbægˌpaɪp>
cassette	kæssɛt	<kəˈsɛt>
defensively	difɛnsaɪvlaɪ	<dɪˈfɛnsɪvli>
dauphin	doʊfɪn	<ˈdaʊfɪn>
incubator	ɪnkubɑtɔr	<ˈɪŋkjəˌbeɪtər>
turnout	tərnaʊt	<ˈtərˌnaʊt>
synchronize	sɪnʧroʊnaɪz	<ˈsɪŋkrəˌnaɪz>
conditioned	kɑndaɪtaɪnd	<kənˈdɪʃənd>
bathrobe	bæθroʊb	<ˈbæθˌroʊb>
bringing	brɪŋɪŋ	<ˈbrɪŋɪŋ>
cannery	kænnɛrjaɪ	<ˈkænəri>
snowshoe	snoʊʃoʊ	<sˈnoʊˌʃu>
grinder	grɪndər	<ˈgraɪndər>
onion	ɑnɪɑn	<ˈənjən>
florin	flɔrɪn	<ˈflɔrɪn>
unrivaled	ənraɪveɪld	<ənˈraɪvəld>
winger	wɪŋər	<ˈwɪŋər>
auspices	ɑzpɪkɛs	<ˈɔspɪsɪz>
abbey	æbbeɪ	<ˈæbi>
speculating	spɛkulætɪŋ	<ˈspɛkjəˌleɪtɪŋ>
pathway	pæθweɪ	<ˈpæθˌweɪ>
rookie	rʊkaɪ	<ˈrʊki>
mathematically	mæθimætaɪkællaɪ	<ˌmæθəˈmætɪkəli>
correlation	kɔrrilɑtaɪn	<ˌkɔrəˈleɪʃən>
kidnapping	kɪdnæppɪŋ	<ˈkɪdˌnæpɪŋ>
coupler	kuplər	<ˈkəplər>
sewer	suər	<suər>
thoroughfare	θɔrəffɛr	<ˈθəroʊˌfɛr>
sexist	sɛksɪst	<ˈsɛksɪst>
lox	lɑks	<ləks>
tenth	tɛnθ	<tɛnθ>
chippendale	ʧɪppɛndeɪl	<ˈʧɪpəˌdeɪl>
ponytail	poʊnaɪteɪl	<ˈpoʊniˌteɪl>
module	mɑdjul	<ˈmɑʤul>
readability	rɛdeɪbɪlaɪtaɪ	<ˌridəˈbɪlɪti>
autopsy	oʊtɑpsaɪ	<ˈɔˌtɑpsi>
wartime	wɑrtaɪm	<ˈwɔrˌtaɪm>
oblong	ɑblɑŋ	<ˈɑblɔŋ>
lowering	loʊərɪŋ	<loʊərɪŋ>
spleen	spin	<splin>
lithograph	lɪθoʊgræf	<ˈlɪθəˌgræf>
shortfall	ʃɔrtfæl	<ˈʃɔrtˌfɔl>
dispensing	dɪspɛnzɪŋ	<dɪˈspɛnsɪŋ>
powders	paʊdərs	<ˈpaʊdərz>
sporadically	spoʊrædaɪkællaɪ	<spərˈædɪkli>
stung	stəŋ	<stəŋ>
resin	rɛsɪn	<ˈrɛzɪn>
jock	ʤɑk	<ʤɑk>
rebate	ribeɪt	<ˈriˌbeɪt>
writing	rɪtɪŋ	<ˈraɪtɪŋ>
strengthen	stərʧɛn	<ˈstrɛŋθən>
wetness	wɛtnɛs	<ˈwɛtnəs>
biochemistry	baɪoʊʧɛmɪstraɪ	<ˌbaɪoʊˈkɛmɪˌstri>
parabolic	pɑreɪbɑlɪk	<ˌpɛrəˈbɑlɪk>
deprive	dipraɪv	<dɪˈpraɪv>
galore	gɑlɔr	<gəˈlɔr>
prose	proʊz	<proʊz>
encyclical	ɛnkɪklaɪkæl	<ɛnˈsɪklɪkəl>
knockout	nɑkaʊt	<ˈnɑˌkaʊt>
widespread	waɪdsprɛd	<ˈwaɪdˈsprɛd>
cougar	kugɑr	<ˈkugər>
down	daʊn	<daʊn>
rebroadcast	ribroʊdkæst	<riˈbrɔdˌkæst>
stardust	stɑrdəst	<ˈstɑrˌdəst>
nitric	nitrɪk	<ˈnaɪtrɪk>
present	prɛzɛnt	<ˈprɛzənt>
freebie	fribaɪ	<ˈfribi>
raceway	reɪsweɪ	<ˈreɪsˌweɪ>
patio	pɑtioʊ	<ˈpætiˌoʊ>
home	hoʊm	<hoʊm>
coon	kun	<kun>
transcriber	trænskrɪbər	<trænˈskraɪbər>
underhill	əndərhɪl	<ˈəndərˌhɪl>
ideal	aɪdiæl	<aɪˈdil>
nightclub	naɪtkləb	<ˈnaɪtˌkləb>
introspection	ɪntroʊspɛktaɪn	<ˌɪntrəˈspɛkʃən>
oilseed	ɔɪlsid	<ˈɔɪlˌsid>
recording	rikɔrdɪŋ	<rɪˈkɔrdɪŋ>
esprit	ɛsprɪt	<ɛˈspri>
merits	mɛrɪts	<ˈmɛrɪts>
frustrated	frəstrætɛd	<ˈfrəˌstreɪtəd>
creamy	krimjaɪ	<ˈkrimi>
verbena	vərbinɑ	<vərˈbinə>
regionally	rigɪnællaɪ	<ˈriʤənəli>
disruption	dɪsrəptaɪn	<dɪsˈrəpʃən>
salami	sɑlɑmi	<səˈlɑmi>
transcribed	trænskraɪbd	<trænˈskraɪbd>
commissary	kɑmmɪssɑrjaɪ	<ˈkɑməˌsɛri>
gilded	gɪldɛd	<ˈgɪldɪd>
kickoff	kɪkɔf	<ˈkɪˌkɔf>
ketone	kitoʊn	<ˈkitoʊn>
surprisingly	sərprɪsɪŋlaɪ	<səˈpraɪzɪŋli>
rapping	ræppɪŋ	<ˈræpɪŋ>
eating	itɪŋ	<ˈitɪŋ>
olfactory	oʊlfæktoʊraɪ	<oʊlˈfæktəri>
gasoline	gæsoʊlaɪn	<ˈgæsəˌlin>
snuck	sək	<snək>
bedrock	bɛdrɑk	<ˈbɛˌdrɑk>
hammock	hæmmɑk	<ˈhæmək>
importation	ɪmpɔrtɑtaɪn	<ˌɪmpɔrˈteɪʃən>
namesake	neɪmseɪk	<ˈneɪmˌseɪk>
extinguisher	ɛkstɪngɪʃər	<ɪkˈstɪŋgwɪʃər>
evergreen	ɛvərgrin	<ˈɛvərˌgrin>
roommate	rummeɪt	<ˈruˌmeɪt>
melamine	mɛleɪmaɪn	<ˈmɛləˌmin>
residency	rɛsaɪdɛnkaɪ	<ˈrɛzɪdənsi>
multicolored	məltikɑlɔrd	<ˌməltiˈkələrd>
muscle	məskli	<ˈməsəl>
messy	mɛsjaɪ	<ˈmɛsi>
impediment	ɪmpɛdaɪmɛnt	<ˌɪmˈpɛdəmənt>
garnett	gɑrnɛt	<ˈgɑrnɪt>
gruesome	grusoʊm	<ˈgrusəm>
book	bʊk	<bʊk>
resumed	risumd	<rɪˈzumd>
unmet	ənmɛt	<ənˈmɛt>
