ing	<ɪŋ>
de	<də>
arc	<ɑrk>
ore	<ɔr>
re	<ri>
spec	<spɛk>
ly	<laɪ>
al	<æl>
ism	<ˈɪzəm>
in	<ɪn>
lid	<lɪd>
i	<aɪ>
ty	<taɪ>
mi	<mi>
cro	<kroʊ>
pro	<proʊ>
sor	<sɔr>
des	<dɪ>
ti	<ti>
en	<ɛn>
ter	<tər>
ire	<aɪr>
se	<seɪ>
con	<kɑn>
let	<lɛt>
cuff	<kəf>
dis	<dɪs>
miss	<mɪs>
ag	<ˈeɪˈgi>
ate	<eɪt>
surf	<sərf>
er	<ər>
signed	<saɪnd>
hon	<hɑn>
es	<ɛs>
now	<naʊ>
a	<ə>
days	<deɪz>
cy	<saɪ>
cling	<klɪŋ>
mod	<mɔd>
est	<ɛst>
cap	<kæp>
tat	<tæt>
ed	<ɛd>
mis	<mɪs>
rep	<rɛpriˈzɛtətɪv>
sent	<sɛnt>
bad	<bæd>
min	<mɪn>
ton	<tən>
rev	<rɛv>
o	<oʊ>
lu	<lu>
ar	<ɑr>
for	<fər>
got	<gɑt>
it	<ɪt>
stu	<stu>
pas	<pɑz>
to	<tɪ>
mu	<mu>
tu	<tu>
e	<i>
merged	<mərʤd>
brace	<breɪs>
ture	<tʊr>
on	<ɔn>
ten	<tɛn>
dwell	<dwɛl>
tea	<ti>
pot	<pɑt>
val	<væl>
u	<ju>
duc	<dək>
bi	<baɪ>
faith	<feɪθ>
nod	<nɑd>
ducks	<dəks>
ba	<ˌbiˈeɪ>
deem	<dim>
cuss	<kəs>
need	<nid>
trans	<trænz>
form	<fɔrm>
pol	<pɔl>
y	<waɪ>
screen	<skrin>
cat	<kæt>
suit	<sut>
bow	<boʊ>
cor	<kɔr>
na	<nɑ>
grad	<græd>
out	<aʊt>
ex	<ɛks>
break	<breɪk>
up	<əp>
pre	<pri>
di	<di>
pi	<paɪ>
pa	<pɑ>
gar	<gɑr>
un	<ˈjuˈɛn>
ni	<ni>
bly	<blaɪ>
tin	<tɪn>
prom	<prɑm>
ul	<əl>
ga	<ˈʤɔrʤə>
la	<lɑ>
cent	<sɛnt>
tre	<treɪ>
lees	<liz>
ac	<ˈeɪˈsi>
firm	<fərm>
ware	<wɛr>
fugue	<fjug>
guilt	<gɪlt>
ad	<æd>
no	<noʊ>
mic	<mɪk>
mo	<moʊ>
tor	<tɔr>
sump	<səmp>
croc	<krɑk>
par	<pɑr>
med	<mɛd>
spout	<spaʊt>
broad	<brɔd>
cord	<kɔrd>
im	<ɪm>
der	<dər>
writ	<rɪt>
scarves	<skɑrvz>
an	<ən>
da	<ˈdiˈeɪ>
au	<oʊ>
burn	<bərn>
she	<ʃi>
pug	<pəg>
height	<haɪt>
blan	<blæn>
weight	<weɪt>
ta	<tɑ>
thi	<θi>
one	<wən>
ma	<mɑ>
lam	<læm>
ditch	<dɪʧ>
ap	<ˌeɪˈpi>
point	<pɔɪnt>
strict	<strɪkt>
croft	<krɔft>
game	<geɪm>
hy	<haɪ>
per	<pər>
sub	<səb>
lease	<lis>
gen	<ʤɛn>
sine	<saɪn>
road	<roʊd>
house	<haʊs>
fan	<fæn>
fare	<fɛr>
sep	<ˈɛˈsiˈpi>
ra	<rɑ>
flung	<fləŋ>
last	<læst>
co	<koʊ>
ney	<neɪ>
met	<mɛt>
ric	<rɪk>
cau	<koʊ>
li	<li>
flow	<floʊ>
gloom	<glum>
cal	<kæl>
man	<mæn>
gate	<geɪt>
sec	<sɛk>
thane	<θeɪn>
lot	<lɔt>
smooth	<smuð>
ness	<nɛs>
latch	<læʧ>
vere	<vɪr>
bat	<bæt>
field	<fild>
mist	<mɪst>
glob	<glɑb>
lin	<lɪn>
by	<baɪ>
stand	<stænd>
death	<dɛθ>
lock	<lɑk>
what	<wət>
not	<nɑt>
brat	<bræt>
pur	<pər>
sued	<sud>
pose	<poʊz>
big	<bɪg>
gest	<ʤɛst>
day	<deɪ>
dream	<drim>
si	<si>
lax	<læks>
jour	<ʤur>
gum	<gəm>
my	<maɪ>
rad	<ræd>
zeal	<zil>
ot	<ˈoʊˈti>
roused	<raʊzd>
fore	<fɔr>
told	<toʊld>
nom	<nɑm>
nat	<næt>
ne	<ni>
com	<kɑm>
briefs	<brifs>
tri	<traɪ>
ca	<ˈsiˈeɪ>
pen	<pɛn>
head	<hɛd>
nap	<næp>
hatch	<hæʧ>
go	<goʊ>
or	<ər>
gan	<gæn>
fool	<ful>
ish	<ɪʃ>
fis	<fɪs>
shown	<ʃoʊn>
try	<traɪ>
fac	<fæk>
pris	<prɪs>
crawl	<krɔl>
pan	<pæn>
ram	<ræm>
net	<nɛt>
chan	<ʧæn>
nel	<nɛl>
as	<ɛz>
so	<soʊ>
tobe	<toʊb>
whence	<wɛns>
use	<juz>
cep	<sɛp>
han	<hɑn>
bar	<bɑr>
dorn	<dɔrn>
gawk	<gɔk>
mit	<ˈɛˈmaɪˈti>
tal	<tɑl>
sort	<sɔrt>
nu	<nu>
is	<ɪz>
tak	<tæk>
mind	<maɪnd>
ah	<ɑ>
sil	<sɪl>
sense	<sɛns>
less	<lɛs>
court	<kɔrt>
op	<ɔp>
at	<æt>
trac	<træk>
fair	<fɛr>
might	<maɪt>
plas	<plæs>
gold	<goʊld>
fish	<fɪʃ>
ab	<æb>
do	<du>
pig	<pɪg>
men	<mɛn>
rode	<roʊd>
ward	<wɔrd>
exec	<ˌɛgˈzɛk>
each	<iʧ>
pres	<prɛz>
sant	<sænt>
stat	<stæt>
bib	<bɪb>
og	<ɑg>
phy	<faɪ>
spark	<spɑrk>
nut	<nət>
cus	<ˈsiˈjuˈɛs>
base	<beɪs>
board	<bɔrd>
bluff	<bləf>
sa	<sɑ>
dat	<dæt>
wash	<wɑʃ>
brad	<bræd>
parr	<pɑr>
ver	<vər>
breed	<brid>
ard	<ɑrd>
cel	<sɛl>
lo	<loʊ>
back	<bæk>
spill	<spɪl>
vain	<veɪn>
ev	<ɛv>
pos	<ˈpiˈoʊˈɛs>
bil	<bɪl>
some	<səm>
lie	<laɪ>
mine	<maɪn>
leu	<lu>
ko	<koʊ>
class	<klæs>
throm	<θrɑm>
bin	<bɪn>
fath	<fæθ>
trite	<traɪt>
mat	<mæt>
mud	<məd>
yep	<jɛp>
sym	<sɪm>
bol	<bɑl>
clear	<klɪr>
climb	<klaɪm>
boose	<bus>
flo	<floʊ>
el	<ɛl>
with	<wɪθ>
rec	<rɛk>
den	<dɛn>
fi	<fi>
mir	<mɪr>
green	<grin>
syn	<sɪn>
the	<ðə>
grin	<grɪn>
luck	<lək>
soft	<sɔft>
ball	<bɔl>
act	<ækt>
nine	<naɪn>
law	<lɔ>
seas	<siz>
bomb	<bɔm>
roast	<roʊst>
boo	<bu>
puss	<pʊs>
sum	<səm>
howe	<haʊ>
droid	<drɔɪd>
mim	<mɪm>
waist	<weɪst>
tho	<ðoʊ>
year	<jɪr>
book	<bʊk>
wave	<weɪv>
sign	<saɪn>
ee	<i>
um	<əm>
calf	<kæf>
ro	<roʊ>
pine	<paɪn>
vat	<væt>
sim	<sɪm>
ho	<hoʊ>
mol	<mɔl>
past	<pæst>
key	<ki>
stroke	<stroʊk>
gu	<gu>
high	<haɪ>
light	<laɪt>
tol	<tɔl>
reg	<rɛg>
lat	<lɑt>
cow	<kaʊ>
hide	<haɪd>
mar	<mɑr>
neu	<nɔɪ>
rol	<roʊl>
lip	<lɪp>
tic	<tɪk>
pat	<pæt>
drop	<drɔp>
bur	<bər>
scrub	<skrəb>
hance	<hæns>
post	<poʊst>
scar	<skɑr>
blood	<bləd>
wet	<wɛt>
po	<poʊ>
lice	<laɪs>
cos	<kɔs>
tract	<trækt>
grunt	<grənt>
scrape	<skreɪp>
aus	<aʊz>
pic	<pɪk>
blue	<blu>
print	<prɪnt>
san	<sæn>
ship	<ʃɪp>
stock	<stɑk>
walk	<wɔk>
ran	<ræn>
ciao	<ʧaʊ>
ask	<æsk>
lack	<læk>
chant	<ʧænt>
case	<keɪs>
fused	<fjuzd>
hack	<hæk>
match	<mæʧ>
mak	<mæk>
sur	<sər>
il	<ɪl>
fat	<fæt>
ley	<leɪ>
then	<ðɛn>
plan	<plæn>
ning	<nɪŋ>
sul	<səl>
pent	<pɛnt>
tapped	<tæpt>
mil	<mɪl>
tar	<tɑr>
push	<pʊʃ>
spence	<spɛns>
stum	<stəm>
space	<speɪs>
feur	<fər>
car	<kɑr>
dice	<daɪs>
grind	<graɪnd>
low	<loʊ>
rat	<ræt>
thor	<θɔr>
ax	<æks>
lev	<lɛv>
five	<faɪv>
long	<lɔŋ>
tour	<tʊr>
whirl	<wərl>
mon	<mɑn>
logue	<loʊg>
me	<mi>
true	<tru>
em	<ɛm>
mixed	<mɪkst>
blanc	<blæŋk>
masked	<mæskt>
zen	<zɛn>
doh	<doʊ>
mean	<min>
su	<su>
stiff	<stɪf>
glo	<gloʊ>
sin	<sɪn>
dic	<dɪk>
hal	<hæl>
le	<lə>
tran	<træn>
fight	<faɪt>
beam	<bim>
am	<æm>
phi	<faɪ>
bull	<bʊl>
pers	<pərs>
wan	<wɑn>
lust	<ləst>
trus	<trəs>
tee	<ti>
sear	<sɪr>
pae	<paɪ>
sta	<ˈɛˈstiˈeɪ>
clank	<klæŋk>
veil	<veɪl>
sell	<sɛl>
wrong	<rɔŋ>
band	<bænd>
skip	<skɪp>
farm	<fɑrm>
art	<ɑrt>
mor	<mɔr>
row	<roʊ>
lear	<lɪr>
troupe	<trup>
gas	<gæs>
line	<laɪn>
short	<ʃɔrt>
cake	<keɪk>
ale	<eɪl>
fel	<fɛl>
bal	<bæl>
cute	<kjut>
perch	<pərʧ>
jas	<ʤæs>
ret	<rɛt>
dim	<dɪm>
pub	<pəb>
can	<kən>
gyp	<ʤɪp>
sy	<saɪ>
tis	<tɪz>
be	<bi>
tween	<twin>
skeet	<skit>
thrash	<θræʃ>
wat	<wɔt>
tant	<tænt>
scope	<skoʊp>
spa	<spɑ>
wiz	<wɪz>
mum	<məm>
jif	<ʤɪf>
karst	<kɑrst>
los	<lɔs>
chi	<kaɪ>
pep	<pɛp>
stride	<straɪd>
auto	<ˈɔtoʊ>
ried	<rid>
sauce	<sɔs>
tan	<tæn>
lap	<læp>
ping	<pɪŋ>
del	<dɛl>
mam	<ˈɛˈmeɪˈɛm>
bo	<boʊ>
liv	<lɪv>
van	<væn>
mirth	<mərθ>
linked	<lɪŋkt>
bid	<bɪd>
cha	<ʧɑ>
os	<ɑs>
gram	<græm>
ming	<mɪŋ>
peace	<pis>
time	<taɪm>
thank	<θæŋk>
of	<əv>
fend	<fɛnd>
down	<daʊn>
mal	<mæl>
lar	<lɑr>
seis	<sis>
rut	<rət>
node	<noʊd>
mas	<mɑz>
vail	<veɪl>
ent	<ɛnt>
brew	<bru>
rain	<reɪn>
pup	<pəp>
flu	<flu>
res	<reɪz>
sax	<sæks>
dung	<dəŋ>
bob	<bɑb>
sled	<slɛd>
gran	<græn>
ose	<oʊz>
dol	<dɑl>
gaunt	<gɔnt>
brock	<brɑk>
loft	<lɔft>
ling	<lɪŋ>
phen	<fɛn>
lux	<ləks>
strip	<strɪp>
ant	<ænt>
tut	<tət>
pert	<pərt>
flam	<flæm>
boy	<bɔɪ>
fu	<fu>
sus	<səs>
toon	<tun>
grace	<greɪs>
kin	<kɪn>
boned	<boʊnd>
wards	<wɔrdz>
train	<treɪn>
stag	<stæg>
gess	<ʤɛs>
turn	<tərn>
round	<raʊnd>
gag	<gæg>
erk	<ərk>
lon	<lɑn>
lisle	<laɪəl>
eyed	<aɪd>
nerves	<nərvz>
name	<neɪm>
plate	<pleɪt>
te	<ti>
por	<pɔr>
sis	<sɪs>
whine	<waɪn>
dull	<dəl>
crim	<krɪm>
land	<lænd>
odd	<ɑd>
feet	<fit>
bark	<bɑrk>
fir	<fər>
pros	<proʊz>
her	<hər>
vis	<vɪs>
knight	<naɪt>
growth	<groʊθ>
tice	<taɪs>
false	<fɔls>
rig	<rɪg>
pressed	<prɛst>
boob	<bub>
cou	<ku>
rant	<rænt>
nit	<nɪt>
fin	<fɪn>
priest	<prist>
clap	<klæp>
brim	<brɪm>
tig	<tɪg>
vine	<vaɪn>
great	hum	<həm>
most	<moʊst>
loch	<lɑk>
gripe	<graɪp>
net	<nɛt>
phone	<foʊn>
ade	<eɪd>
cep	<sɛp>
tent	<tɛnt>
tho	<ðoʊ>
mack	<mæk>
tosh	<tɑʃ>
core	<kɔr>
cel	<sɛl>
fuss	<fəs>
jaw	<ʤɔ>
crude	<krud>
glad	<glæd>
cern	<sərn>
safe	<seɪf>
known	<noʊn>
tai	<taɪ>
weld	<wɛld>
writ	<rɪt>
hogg	<hɑg>
shake	<ʃeɪk>
dith	<dɪθ>
test	<tɛst>
seen	<sin>
inn	<ɪn>
cham	<ʧæm>
mile	<maɪl>
mon	<mɑn>
lish	<lɪʃ>
take	<teɪk>
snug	<snəg>
heard	<hərd>
port	<pɔrt>
mid	<mɪd>
win	<wɪn>
cid	<sɪd>
well	<wɛl>
nite	<naɪt>
jew	<ʤu>
thar	<θɑr>
coach	<koʊʧ>
pas	<pɑz>
sub	<səb>
bleed	<blid>
phy	<faɪ>
carl	<kɑrl>
tis	<tɪz>
cleans	<klinz>
tax	<tæks>
pied	<paɪd>
pur	<pər>
doe	<doʊ>
sized	<saɪzd>
plan	<plæn>
ning	<nɪŋ>
stet	<stɛt>
lash	<læʃ>
pol	<pɔl>
wick	<wɪk>
gan	<gæn>
build	<bɪld>
ju	<ʤu>
mer	<mɛr>
ad	<æd>
prob	<prɑb>
creep	<krip>
rah	<rɑ>
biz	<bɪz>
prince	<prɪns>
dic	<dɪk>
fig	<fɪg>
ur	<ər>
rack	<ræk>
wail	<weɪl>
sauce	<sɔs>
view	<vju>
clips	<klɪps>
verse	<vərs>
gent	<ʤɛnt>
dog	<dɔg>
pomp	<pɑmp>
hut	<hət>
maid	<meɪd>
cob	<kɑb>
os	<ɑs>
drain	<dreɪn>
m	<ɛm>
l	<ɛl>
ted	<tɛd>
cry	<kraɪ>
gen	<ʤɛn>
chaff	<ʧæf>
rab	<ræb>
ail	<eɪl>
lide	<laɪd>
snake	<sneɪk>
hold	<hoʊld>
mel	<mɛl>
coat	<koʊt>
lid	<lɪd>
fill	<fɪl>
his	<hɪz>
mote	<moʊt>
morn	<mɔrn>
dent	<dɛnt>
ros	<rɔs>
weep	<wip>
og	<ɑg>
pay	<peɪ>
ee	<i>
sym	<sɪm>
gasp	<gæsp>
dif	<dɪf>
mic	<mɪk>
wood	<wʊd>
die	<daɪ>
stand	<stænd>
rail	<reɪl>
ref	<rɛf>
dum	<dəm>
lage	<leɪʤ>
gloom	<glum>
loon	<lun>
neg	<nɛg>
birch	<bərʧ>
vin	<vɪn>
yeo	<ˈjioʊ>
pent	<pɛnt>
house	<haʊs>
ab	<æb>
brunt	<brənt>
mom	<mɑm>
vast	<væst>
raz	<ræz>
zi	<zi>
ord	<ɔrd>
fan	<fæn>
sew	<soʊ>
pressed	<prɛst>
spat	<spæt>
pat	<pæt>
stat	<stæt>
ure	<jur>
dank	<dæŋk>
fur	<fər>
sip	<sɪp>
ping	<pɪŋ>
math	<mæθ>
jane	<ʤeɪn>
yule	<jul>
flu	<flu>
lute	<lut>
strep	<strɛp>
short	<ʃɔrt>
poor	<pur>
scribe	<skraɪb>
bic	<bɪk>
it	<ɪt>
air	<ɛr>
lift	<lɪft>
share	<ʃɛr>
ole	<ˌoʊˈleɪ>
tag	<tæg>
nist	<nɪst>
phase	<feɪz>
drove	<droʊv>
boot	<but>
leg	<lɛg>
dike	<daɪk>
cop	<kɑp>
vent	<vɛnt>
food	<fud>
god	<gɑd>
seam	<sim>
if	<ɪf>
fore	<fɔr>
closed	<kloʊzd>
scarves	<skɑrvz>
cum	<kəm>
ski	<ski>
damp	<dæmp>
ho	<hoʊ>
till	<tɪl>
plunge	<plənʤ>
eighth	<eɪθ>
ant	<ænt>
cap	<kæp>
kraft	<kræft>
strap	<stræp>
chae	<ʧaɪ>
gist	<ʤɪst>
dae	<deɪ>
que	<kju>
ric	<rɪk>
heath	<hiθ>
quail	<kweɪl>
tile	<taɪl>
lem	<lɛm>
rag	<ræg>
ged	<ˈʤiˈiˈdi>
il	<ɪl>
gal	<gæl>
nag	<næg>
duc	<dək>
cut	<kət>
nod	<nɑd>
cate	<keɪt>
zip	<zɪp>
barge	<bɑrʤ>
for	<fər>
tar	<tɑr>
scrap	<skræp>
book	<bʊk>
tex	<tɛks>
ounce	<aʊns>
two	<tu>
fold	<foʊld>
list	<lɪst>
mine	<maɪn>
world	<wərld>
prom	<prɑm>
ret	<rɛt>
aux	<oʊ>
truss	<trəs>
salm	<sɑm>
tick	<tɪk>
bit	<bɪt>
vers	<vərs>
class	<klæs>
vest	<vɛst>
bridge	<brɪʤ>
wait	<weɪt>
flask	<flæsk>
start	<stɑrt>
news	<nuz>
din	<dɪn>
cliff	<klɪf>
spas	<spɑz>
trick	<trɪk>
taint	<teɪnt>
lan	<læn>
yard	<jɑrd>
rave	<reɪv>
dat	<dæt>
charged	<ʧɑrʤd>
bes	<biz>
gain	<geɪn>
wares	<wɛrz>
eb	<ɛb>
ren	<rɛn>
mam	<ˈɛˈmeɪˈɛm>
sump	<səmp>
off	<ɔf>
beat	<bit>
seat	<sit>
lump	<ləmp>
ard	<ɑrd>
brows	<braʊz>
sir	<sər>
rock	<rɑk>
hill	<hɪl>
dec	<dɛk>
meth	<mɛθ>
hot	<hɑt>
super	<ˈsupər>
vet	<vɛt>
ru	<ˈɑˈrju>
flew	<flu>
tan	<tæn>
ches	<ʧɛs>
bra	<brɑ>
fab	<fæb>
bulk	<bəlk>
of	<əv>
fence	<fɛns>
hom	<hɑm>
fed	<fɛd>
town	<taʊn>
ploy	<plɔɪ>
kiln	<kɪln>
length	<lɛŋθ>
sloth	<sloʊθ>
lab	<læb>
chest	<ʧɛst>
ties	<taɪz>
tend	<tɛnd>
life	<laɪf>
rain	<reɪn>
bow	<boʊ>
fraud	<frɔd>
kin	<kɪn>
qui	<ki>
qua	<kwɑ>
r	<ɑr>
loath	<loʊθ>
fun	<fən>
first	<fərst>
broth	<brɔθ>
love	<ləv>
drink	<drɪŋk>
van	<væn>
grab	<græb>
wold	<woʊld>
scrub	<skrəb>
bing	<bɪŋ>
blouse	<blaʊs>
size	<saɪz>
gram	<græm>
pimp	<pɪmp>
rook	<rʊk>
ace	<eɪs>
poss	<pɔs>
ve	<vi>
nous	<nus>
push	<pʊʃ>
dry	<draɪ>
sy	<saɪ>
flog	<flɑg>
band	<bænd>
thane	<θeɪn>
aim	<eɪm>
tim	<tɪm>
land	<lænd>
jua	<ʤuə>
thrash	<θræʃ>
iq	<ˈaɪˈkju>
hen	<hɛn>
spoon	<spun>
sig	<sɪg>
board	<bɔrd>
tell	<tɛl>
floats	<floʊts>
shek	<ʃɛk>
rang	<ræŋ>
pal	<pæl>
why	<waɪ>
flop	<flɑp>
g	<ʤi>
tech	<tɛk>
nic	<nɪk>
quad	<kwɑd>
syn	<sɪn>
gee	<ʤi>
nam	<næm>
risk	<rɪsk>
that	<ðət>
coup	<ku>
pork	<pɔrk>
week	<wik>
east	<ist>
flam	<flæm>
empt	<ɛmt>
dill	<dɪl>
lene	<lin>
sales	<seɪlz>
north	<nɔrθ>
pour	<pɔr>
smirk	<smərk>
ward	<wɔrd>
fugue	<fjug>
pass	<pæs>
pock	<pɑk>
gig	<gɪg>
brack	<bræk>
pres	<prɛz>
nil	<nɪl>
cause	<kɔz>
stick	<stɪk>
white	<waɪt>
fish	<fɪʃ>
pon	<pɑn>
toon	<tun>
our	<ɑr>
show	<ʃoʊ>
pus	<pəs>
dough	<doʊ>
cha	<ʧɑ>
bond	<bɑnd>
field	<fild>
bead	<bid>
slay	<sleɪ>
gil	<gɪl>
weir	<wir>
sport	<spɔrt>
nan	<næn>
yet	<jɛt>
jack	<ʤæk>
pot	<pɑt>
brain	<breɪn>
hearth	<hɑrθ>
rate	<reɪt>
tense	<tɛns>
pip	<pɪp>
pin	<pɪn>
ise	<aɪz>
reck	<rɛk>
chart	<ʧɑrt>
see	<si>
tow	<toʊ>
joint	<ʤɔɪnt>
kain	<keɪn>
serv	<sərv>
thrust	<θrəst>
lim	<lɪm>
trap	<træp>
trunk	<trəŋk>
check	<ʧɛk>
hire	<haɪər>
ze	<zeɪ>
lite	<laɪt>
p>
drake	<dreɪk>
east	<ist>
crook	<krʊk>
frieze	<friz>
aye	<aɪ>
bridged	<brɪʤd>
tech	<tɛk>
hard	<hɑrd>
neck	<nɛk>
lace	<leɪs>
cher	<ʃɛr>
fed	<fɛd>
ban	<bæn>
mid	<mɪd>
fault	<fɔlt>
spite	<spaɪt>
m	<ɛm>
l	<ɛl>
bisque	<bɪsk>
rest	<rɛst>
spic	<spɪk>
tics	<tɪks>
les	<lɛs>
tire	<taɪər>
wain	<weɪn>
wright	<raɪt>
half	<hæf>
way	<weɪ>
deck	<dɛk>
bill	<bɪl>
picked	<pɪkt>
chas	<ʧɑz>
duct	<dəkt>
quan	<kwɔn>
tilt	<tɪlt>
char	<ʧɑr>
born	<bɔrn>
maine	<meɪn>
brown	<braʊn>
urn	<ərn>
seam	<sim>
silk	<sɪlk>
fire	<faɪər>
fly	<flaɪ>
judge	<ʤəʤ>
lib	<lɪb>
guard	<gɑrd>
far	<fɑr>
snug	<snəg>
arch	<ɑrʧ>
front	<frənt>
chat	<ʧæt>
shaw	<ʃɔ>
tet	<tɛt>
teach	<tiʧ>
rus	<rəs>
sad	<sæd>
hunt	<hənt>
king	<kɪŋ>
lake	<leɪk>
take	<teɪk>
ude	<ud>
din	<dɪn>
spire	<spaɪr>
taint	<teɪnt>
hops	<hɑps>
wait	<weɪt>
ress	<rɛs>
beak	<bik>
mate	<meɪt>
flack	<flæk>
arts	<ɑrts>
bee	<bi>
keep	<kip>
knit	<nɪt>
wynn	<wɪn>
heart	<hɑrt>
stretch	<strɛʧ>
id	<ˈaɪˈdi>
dec	<dɛk>
peal	<pil>
part	<pɑrt>
pip	<pɪp>
sick	<sɪk>
gath	<gæθ>
cost	<kɔst>
which	<wɪʧ>
ink	<ɪŋk>
pal	<pæl>
rafe	<reɪf>
mix	<mɪks>
mac	<mæk>
saw	<sɔ>
mill	<mɪl>
vo	<voʊ>
saint	<seɪnt>
pick	<pɪk>
wil	<wɪl>
har	<hɑr>
pools	<pulz>
milt	<mɪlt>
ted	<tɛd>
dress	<drɛs>
hire	<haɪər>
vault	<vɔlt>
cop	<kɑp>
its	<ɪts>
lob	<lɑb>
rob	<rɑb>
bet	<bɛt>
fought	<fɔt>
course	<kɔrs>
bed	<bɛd>
pap	<pæp>
flash	<flæʃ>
sig	<sɪg>
mack	<mæk>
naw	<nɑ>
drink	<drɪŋk>
grape	<greɪp>
fruit	<frut>
health	<hɛlθ>
lea	<li>
doc	<dɑk>
opt	<ɑpt>
door	<dɔr>
jo	<ʤoʊ>
nee	<ni>
rea	<reɪ>
fence	<fɛns>
posed	<poʊzd>
care	<kɛr>
wrench	<rɛnʧ>
doors	<dɔrz>
shades	<ʃeɪdz>
slur	<slər>
quirk	<kwərk>
sher	<ʃər>
dame	<deɪm>
sult	<səlt>
yelp	<jɛlp>
pay	<peɪ>
stair	<stɛr>
ers	<ˈiˈɑˈrɛs>
fil	<fɪl>
lil	<lɪl>
prism	<ˈprɪzəm>
bel	<bɛl>
rang	<ræŋ>
mort	<mɔrt>
gee	<ʤi>
sun	<sən>
gist	<ʤɪst>
shall	<ʃæl>
show	<ʃoʊ>
stamp	<stæmp>
slip	<slɪp>
shield	<ʃild>
vic	<vɪk>
pore	<pɔr>
nan	<næn>
greet	<grit>
weak	<wik>
nies	<naɪz>
crazed	<kreɪzd>
inc	<ɪŋk>
suc	<sək>
horse	<hɔrs>
ker	<kər>
shad	<ʃæd>
owed	<oʊd>
sought	<sɔt>
code	<koʊd>
burse	<bərs>
rout	<raʊt>
volt	<voʊlt>
dew	<du>
trib	<trɪb>
seed	<sid>
drill	<drɪl>
bite	<baɪt>
used	<juzd>
week	<wik>
mused	<mjuzd>
when	<wɪn>
come	<kəm>
jump	<ʤəmp>
port	<pɔrt>
tube	<tub>
park	<pɑrk>
oat	<oʊt>
crunch	<krənʧ>
bulb	<bəlb>
speech	<spiʧ>
ries	<raɪz>
who	<hu>
gorge	<gɔrʤ>
snob	<snɑb>
hur	<hər>
cane	<keɪn>
weed	<wid>
cern	<sərn>
gem	<ʤɛm>
hug	<həg>
ging	<ʤɪŋ>
free	<fri>
troy	<trɔɪ>
pull	<pʊl>
placed	<pleɪst>
clean	<klin>
buds	<bədz>
fairs	<fɛrz>
shore	<ʃɔr>
draw	<drɔ>
nick	<nɪk>
trap	<træp>
blind	<blaɪnd>
n	<ɛn>
v	<vi>
hate	<heɪt>
arm	<ɑrm>
floor	<flɔr>
squall	<skwɔl>
nec	<nɛk>
sar	<sɑr>
vance	<væns>
cress	<krɛs>
gig	<gɪg>
bread	<brɛd>
vet	<vɛt>
sit	<sɪt>
cut	<kət>
hum	<həm>
don	<dɑn>
zone	<zoʊn>
spun	<spən>
drew	<dru>
fleet	<flit>
pease	<piz>
sketch	<skɛʧ>
whip	<wɪp>
shred	<ʃrɛd>
build	<bɪld>
bit	<bɪt>
kay	<keɪ>
yak	<jæk>
sex	<sɛks>
wrap	<ræp>
yam	<jæm>
mag	<mæg>
bug	<bəg>
bound	<baʊnd>
watt	<wɑt>
eye	<aɪ>
brow	<braʊ>
wisp	<wɪsp>
plank	<plæŋk>
tread	<trɛd>
pet	<pɛt>
czar	<zɑr>
sol	<sɑl>
ramp	<ræmp>
worse	<wərs>
pinned	<pɪnd>
skilled	<skɪld>
skim	<skɪm>
dent	<dɛnt>
apt	<æpt>
grant	<grænt>
ruled	<ruld>
cote	<koʊt>
drum	<drəm>
burnt	<bərnt>
dad	<dæd>
bile	<baɪl>
pear	<pɛr>
group	<grup>
check	<ʧɛk>
wert	<wərt>
wren	<rɛn>
lou	<lu>
gang	<gæŋ>
three	<θri>
guest	<gɛst>
plus	<pləs>
boots	<buts>
rap	<ræp>
slain	<sleɪn>
mild	<maɪld>
cur	<kər>
nied	<nid>
herb	<ərb>
sass	<sæs>
ya	<jɑ>
right	<raɪt>
cum	<kəm>
nor	<nɔr>
blip	<blɪp>
hair	<hɛr>
wick	<wɪk>
geon	<ʤiɑn>
stroll	<stroʊl>
dark	<dɑrk>
bang	<bæŋ>
bier	<bir>
chard	<ʧɑrd>
blow	<bloʊ>
rib	<rɪb>
bon	<bɑn>
lish	<lɪʃ>
well	<wɛl>
empt	<ɛmt>
win	<wɪn>
salts	<sɔlts>
laced	<leɪst>
hope	<hoʊp>
through	<θru>
found	<faʊnd>
sleuth	<sluθ>
call	<kɔl>
fee	<fi>
dare	<dɛr>
cian	<ʃin>
taut	<tɔt>
frain	<freɪn>
spend	<spɛnd>
tank	<tæŋk>
throne	<θroʊn>
just	<ʤɪst>
get	<gɪt>
leng	<lɛŋ>
mitch	<mɪʧ>
clot	<klɑt>
aux	<oʊ>
ia	<ˈiə>
beat	<bit>
keen	<kin>
bank	<bæŋk>
roll	<roʊl>
hole	<hoʊl>
broth	<brɔθ>
hom	<hɑm>
ace	<eɪs>
snips	<snɪps>
shit	<ʃɪt>
nance	<næns>
plain	<pleɪn>
bunch	<bənʧ>
ketch	<kɛʧ>
dries	<draɪz>
old	<oʊld>
ledge	<lɛʤ>
nes	<nɛs>
wal	<wɔl>
vert	<vərt>
neer	<nɪr>
rip	<rɪp>
step	<stɛp>
wise	<waɪz>
jinx	<ʤɪŋks>
pock	<pɑk>
jar	<ʤɑr>
proof	<pruf>
tore	<tɔr>
run	<rən>
stam	<stæm>
wilt	<wɪlt>
pleased	<plizd>
noose	<nus>
dos	<dɔs>
stoned	<stoʊnd>
vague	<veɪg>
blown	<bloʊn>
hunk	<həŋk>
ame	<eɪm>
puke	<pjuk>
las	<ˈɛˈleɪˈɛs>
rid	<rɪd>
fit	<fɪt>
test	<tɛst>
whole	<hoʊl>
fer	<fɛr>
ring	<rɪŋ>
cod	<ˈsiˈoʊˈdi>
gear	<gɪr>
box	<bɑks>
third	<θərd>
bert	<bərt>
goods	<gʊdz>
lieu	<lu>
stol	<stoʊl>
cade	<keɪd>
shear	<ʃɪr>
pee	<pi>
vest	<vɛst>
stint	<stɪnt>
spiel	<spil>
bort	<bɔrt>
cup	<kəp>
he	<hi>
joy	<ʤɔɪ>
teas	<tiz>
rook	<rʊk>
squirt	<skwərt>
fold	<foʊld>
grade	<greɪd>
fang	<fæŋ>
slat	<slæt>
fun	<fən>
league	<lig>
sci	<ˈɛsˈsiˈaɪ>
stick	<stɪk>
dea	<di>
ess	<ɛs>
sound	<saʊnd>
tonk	<tɔŋk>
crafts	<kræfts>
bust	<bəst>
mos	<mɔs>
pea	<pi>
phil	<fɪl>
poon	<pun>
shine	<ʃaɪn>
strange	<streɪnʤ>
jeep	<ʤip>
ilk	<ɪlk>
chap	<ʧæp>
phone	<foʊn>
doo	<du>
ridge	<rɪʤ>
dam	<dæm>
dooms	<dumz>
nip	<nɪp>
yeo	<ˈjioʊ>
hooked	<hʊkt>
lau	<laʊ>
hodge	<hɑʤ>
sour	<saʊər>
wipe	<waɪp>
pleas	<pliz>
loon	<lun>
gade	<geɪd>
thin	<θɪn>
elves	<ɛlvz>
chime	<ʧaɪm>
gant	<gænt>
heeled	<hild>
baud	<bɔd>
dab	<dæb>
mange	<meɪnʤ>
buzz	<bəz>
next	<nɛkst>
brush	<brəʃ>
conn	<kɑn>
grebe	<grib>
lab	<læb>
stan	<stæn>
trant	<trænt>
gov	<gəv>
press	<prɛs>
his	<hɪz>
sneak	<snik>
said	<sɛd>
ze	<zeɪ>
cream	<krim>
chet	<ʧɛt>
pair	<pɛr>
wax	<wæks>
feist	<faɪst>
seek	<sik>
rot	<rɑt>
ques	<kwɛs>
pump	<pəmp>
raised	<reɪzd>
loom	<lum>
jus	<ʤəs>
dun	<dən>
proved	<pruvd>
vive	<viv>
sac	<sæk>
flag	<flæg>
boast	<boʊst>
ash	<æʃ>
feud	<fjud>
bop	<bɑp>
quest	<kwɛst>
lan	<læn>
thence	<ðɛns>
peel	<pil>
wealth	<wɛlθ>
graced	<greɪst>
skin	<skɪn>
cot	<kɑt>
shrill	<ʃrɪl>
chase	<ʧeɪs>
raft	<ræft>
clog	<klɑg>
munch	<mənʧ>
pearl	<pərl>
touch	<təʧ>
yoke	<joʊk>
brough	<braʊ>
dant	<dænt>
dep	<dɛp>
foot	<fʊt>
paint	<peɪnt>
pix	<pɪks>
rai	<rɑi>
girl	<gərl>
brass	<bræs>
tap	<tæp>
him	<ɪm>
teem	<tim>
spin	<spɪn>
dif	<dɪf>
slight	<slaɪt>
strep	<strɛp>
font	<fɑnt>
gae	<gaɪ>
noth	<nɑθ>
caw	<kɔ>
breech	<briʧ>
morse	<mɔrs>
husk	<həsk>
rack	<ræk>
poth	<pɑθ>
sized	<saɪzd>
dev	<dɛv>
safe	<seɪf>
freed	<frid>
smelt	<smɛlt>
cay	<keɪ>
fluff	<fləf>
scat	<skæt>
sha	<ʃɑ>
alt	<ɑlt>
plied	<plaɪd>
firsts	<fərsts>
quo	<kwoʊ>
charged	<ʧɑrʤd>
new	<nu>
jen	<ʤɛn>
hey	<heɪ>
thar	<θɑr>
spew	<spju>
bock	<bɑk>
fray	<freɪ>
combe	<koʊm>
gump	<gəmp>
shut	<ʃət>
dau	<doʊ>
thanks	<θæŋks>
twine	<twaɪn>
lead	<lɛd>
nace	<neɪs>
bree	<bri>
lime	<laɪm>
dey	<deɪ>
hang	<hæŋ>
snack	<snæk>
large	<lɑrʤ>
blouse	<blaʊs>
mash	<mæʃ>
pace	<peɪs>
pu	<pu>
brave	<breɪv>
pack	<pæk>
aged	<ˈeɪʤɪd>
wasp	<wɑsp>
think	<θɪŋk>
state	<steɪt>
qua	<kwɑ>
fart	<fɑrt>
mount	<maʊnt>
mitt	<mɪt>
cant	<kænt>
hash	<hæʃ>
lion	<laɪən>
clock	<klɑk>
gin	<ʤɪn>
lant	<lænt>
night	<naɪt>
gale	<geɪl>
crip	<krɪp>
tray	<treɪ>
bland	<blænd>
booth	<buθ>
vide	<vaɪd>
sleet	<slit>
news	<nuz>
stir	<stər>
save	<seɪv>
famed	<feɪmd>
life	<laɪf>
yield	<jild>
sand	<sænd>
ben	<bɛn>
thought	<θɔt>
sty	<staɪ>
lis	<lɪs>
earn	<ərn>
straight	<streɪt>
brief	<brif>
struck	<strək>
from	<frəm>
snip	<snɪp>
weird	<wɪrd>
crimp	<krɪmp>
leased	<list>
charm	<ʧɑrm>
neg	<nɛg>
curd	<kərd>
laugh	<læf>
femme	<fɛm>
grand	<grænd>
hun	<hən>
flan	<flæn>
sue	<su>
lief	<lif>
tail	<teɪl>
tot	<tɑt>
spot	<spɑt>
ise	<aɪz>
wreck	<rɛk>
cliff	<klɪf>
width	<wɪdθ>
roe	<roʊ>
quin	<kwɪn>
knot	<nɑt>
ref	<rɛf>
bleak	<blik>
warm	<wɔrm>
curb	<kərb>
world	<wərld>
pled	<plɛd>
guild	<gɪld>
hall	<hɔl>
stalked	<stɔkt>
bay	<beɪ>
pret	<prɛt>
ultra	<ˈəltrə>
violet	<ˈvaɪəlɪt>
pong	<pɔŋ>
vase	<vɑz>
bud	<bəd>
street	<strit>
tac	<tæk>
grate	<greɪt>
thatch	<θæʧ>
herd	<hərd>
hurt	<hərt>
weeds	<widz>
stub	<stəb>
thrust	<θrəst>
t	<ti>
nase	<neɪz>
pains	<peɪnz>
west	<wɛst>
south	<saʊθ>
hype	<haɪp>
chop	<ʧɑp>
bate	<beɪt>
lapped	<læpt>
swipe	<swaɪp>
marque	<mɑrk>
cloud	<klaʊd>
jam	<ʤæm>
ree	<ri>
lift	<lɪft>
cause	<kɔz>
path	<pæθ>
quire	<kwaɪr>
wank	<wɑŋk>
tact	<tækt>
bird	<bərd>
rock	<rɑk>
twin	<twɪn>
spasm	<ˈspæzəm>
lite	<laɪt>
plumb	<pləm>
ged	<ˈʤiˈiˈdi>
buoy	<bui>
send	<sɛnd>
word	<wərd>
dram	<ˈdiˌræm>
duce	<ˈduˌʧeɪ>
clough	<klaʊ>
good	<gʊd>
will	<wɪl>
whore	<hɔr>
flood	<fləd>
gus	<gəs>
flight	<flaɪt>
hock	<hɑk>
mpg	<ˈɛmˈpiˈʤi>
rogue	<roʊg>
scape	<skeɪp>
tent	<tɛnt>
bove	<boʊv>
piece	<pis>
prey	<preɪ>
gym	<ʤɪm>
thine	<ðaɪn>
soil	<sɔɪl>
gust	<gəst>
berk	<bərk>
bibb	<bɪb>
hood	<hʊd>
charge	<ʧɑrʤ>
hear	<hir>
wean	<win>
blast	<blæst>
nang	<næŋ>
lean	<lin>
quaint	<kweɪnt>
tough	<təf>
flap	<flæp>
rist	<rɪst>
sheet	<ʃit>
pomp	<pɑmp>
hight	<haɪt>
thrush	<θrəʃ>
fresh	<frɛʃ>
das	<dɑs>
gaz	<gɑz>
til	<tɪl>
tude	<tud>
club	<kləb>
frank	<fræŋk>
crude	<krud>
spunk	<spəŋk>
dase	<deɪz>
deal	<dil>
changed	<ʧeɪnʤd>
hearth	<hɑrθ>
help	<hɛlp>
tame	<teɪm>
peck	<pɛk>
rum	<rəm>
loud	<laʊd>
hong	<hɔŋ>
flake	<fleɪk>
lied	<laɪd>
horde	<hɔrd>
chief	<ʧif>
ure	<jur>
dance	<dæns>
locked	<lɑkt>
were	<wər>
moon	<mun>
slacks	<slæks>
breast	<brɛst>
firmed	<fərmd>
burg	<bərg>
pointe	<pɔɪnt>
pon	<pɑn>
strain	<streɪn>
sam	<sæm>
flux	<fləks>
track	<træk>
ae	<eɪ>
work	<wərk>
swords	<sɔrdz>
cry	<kraɪ>
ends	<ɛndz>
town	<taʊn>
crave	<kreɪv>
dow	<daʊ>
merge	<mərʤ>
your	<jʊr>
bus	<bəs>
hertz	<hɛrts>
mire	<maɪər>
pool	<pul>
ache	<eɪk>
kan	<kæn>
lee	<li>
sweet	<swit>
fran	<fræn>
baht	<bɑt>
start	<stɑrt>
hurst	<hərst>
here	<hir>
make	<meɪk>
bies	<baɪz>
see	<si>
hap	<hæp>
jew	<ʤu>
laid	<leɪd>
bump	<bəmp>
pile	<paɪl>
bras	<brɑs>
vast	<væst>
stream	<strim>
wish	<wɪʃ>
buck	<bək>
nag	<næg>
draft	<dræft>
tons	<tənz>
frail	<freɪl>
serve	<sərv>
chrome	<kroʊm>
urge	<ərʤ>
us	<ˈjuˈɛs>
mast	<mæst>
heal	<hil>
nex	<nɛks>
sag	<sæg>
read	<rɛd>
ches	<ʧɛs>
mel	<mɛl>
piles	<paɪlz>
pax	<pæks>
range	<reɪnʤ>
find	<faɪnd>
seal	<sil>
coy	<kɔɪ>
file	<faɪl>
snook	<snʊk>
harsh	<hɑrʃ>
float	<floʊt>
wail	<weɪl>
ground	<graʊnd>
siege	<siʤ>
celt	<sɛlt>
corr	<kɔr>
roar	<rɔr>
sleep	<slip>
like	<laɪk>
quince	<kwɪns>
stuffed	<stəft>
prize	<praɪz>
pog	<pɑg>
woof	<wuf>
scarce	<skɛrs>
chang	<ʧæŋ>
gong	<gɔŋ>
kyu	<kju>
joke	<ʤoʊk>
crease	<kris>
sheikh	<ʃik>
fort	<fɔrt>
hitch	<hɪʧ>
swim	<swɪm>
quake	<kweɪk>
loot	<lut>
meat	<mit>
goon	<gun>
talk	<tɔk>
flat	<flæt>
jest	<ʤɛst>
forth	<fɔrθ>
load	<loʊd>
hex	<hɛks>
cab	<kæb>
solve	<sɑlv>
fife	<faɪf>
skimp	<skɪmp>
aft	<æft>
prem	<prɛm>
ere	<ɛr>
hen	<hɛn>
vote	<voʊt>
edge	<ɛʤ>
dum	<dəm>
rump	<rəmp>
broil	<brɔɪl>
hale	<heɪl>
fined	<faɪnd>
tort	<tɔrt>
cook	<kʊk>
toot	<tut>
jure	<ʤʊr>
most	<moʊst>
wham	<wæm>
spring	<spərɪŋ>
spray	<spreɪ>
bun	<bən>
shunt	<ʃənt>
liz	<lɪz>
rich	<rɪʧ>
leap	<lip>
grown	<groʊn>
works	<wərks>
skill	<skɪl>
throw	<θroʊ>
clam	<klæm>
shell	<ʃɛl>
verb	<vərb>
red	<rɛd>
quack	<kwæk>
hank	<hæŋk>
clem	<klɛm>
they	<ðeɪ>
snail	<sneɪl>
morn	<mɔrn>
ooze	<uz>
naught	<nɔt>
lard	<lɑrd>
wig	<wɪg>
pink	<pɪŋk>
tried	<traɪd>
coupe	<kup>
fess	<fɛs>
carl	<kɑrl>
ding	<dɪŋ>
ruf	<rəf>
garb	<gɑrb>
gue	<gju>
bond	<bɑnd>
sic	<sɪk>
tole	<toʊl>
grist	<grɪst>
hemp	<hɛmp>
toil	<tɔɪl>
folk	<foʊk>
lore	<lɔr>
truth	<truθ>
ou	<u>
av	<ˌeɪˈvi>
draught	<dræft>
pete	<pit>
both	<boʊθ>
card	<kɑrd>
dig	<dɪg>
coach	<koʊʧ>
hymn	<hɪm>
colt	<koʊlt>
punch	<pənʧ>
twist	<twɪst>
zack	<zæk>
span	<spæn>
mote	<moʊt>
team	<tim>
halt	<hɔlt>
whisk	<wɪsk>
thrill	<θrɪl>
dose	<doʊs>
close	<kloʊz>
dog	<dɔg>
loam	<loʊm>
som	<sɑm>
thick	<θɪk>
drove	<droʊv>
view	<vju>
shot	<ʃɑt>
tag	<tæg>
nist	<nɪst>
lia	<ˈliə>
lug	<ləg>
gage	<geɪʤ>
steer	<stɪr>
hop	<hɑp>
sung	<səŋ>
dough	<doʊ>
barb	<bɑrb>
sphinx	<sfɪŋks>
squeak	<skwik>
ankh	<ænk>
frame	<freɪm>
fink	<fɪŋk>
hi	<haɪ>
tow	<toʊ>
role	<roʊl>
flog	<flɑg>
rah	<rɑ>
bean	<bin>
task	<tæsk>
freeze	<friz>
hill	<hɪl>
put	<pʊt>
bog	<bɔg>
hag	<hæg>
waive	<weɪv>
sewn	<soʊn>
bees	<biz>
cog	<kɔg>
bis	<bɪs>
pike	<paɪk>
bic	<bɪk>
mend	<mɛnd>
price	<praɪs>
fall	<fɔl>
pound	<paʊnd>
sault	<sɔlt>
buff	<bəf>
mined	<maɪnd>
beck	<bɛk>
meant	<mɛnt>
slim	<slɪm>
fear	<fɪr>
bolt	<boʊlt>
wag	<wæg>
thon	<θɑn>
hoo	<hu>
liege	<liʤ>
crop	<krɑp>
lands	<lændz>
lop	<lɑp>
mez	<mɛz>
maud	<mɔd>
hid	<hɪd>
finch	<fɪnʧ>
wife	<waɪf>
cheer	<ʧɪr>
mute	<mjut>
nous	<nus>
tracks	<træks>
dust	<dəst>
dens	<dɛnz>
scratch	<skræʧ>
lines	<laɪnz>
glee	<gli>
reel	<ril>
chow	<ʧaʊ>
hound	<haʊnd>
fern	<fərn>
brisk	<brɪsk>
stow	<stoʊ>
bench	<bɛnʧ>
scour	<skaʊər>
pom	<pɔm>
fjord	<fjɔrd>
cured	<kjʊrd>
peat	<pit>
troop	<trup>
checked	<ʧɛkt>
guess	<gɛs>
polled	<poʊld>
rene	<rəˈneɪ>
floss	<flɑs>
quid	<kwɪd>
skirts	<skərts>
tit	<tɪt>
led	<lɛd>
snow	<snoʊ>
pran	<prɑn>
fe	<feɪ>
jac	<ʤæk>
pil	<pɪl>
trove	<troʊv>
choice	<ʧɔɪs>
butch	<bʊʧ>
rage	<reɪʤ>
bab	<bæb>
warn	<wɔrn>
knob	<nɑb>
knife	<naɪf>
quick	<kwɪk>
shoes	<ʃuz>
nov	<noʊv>
search	<sərʧ>
trait	<treɪt>
myth	<mɪθ>
cloth	<klɔθ>
roan	<roʊn>
trend	<trɛnd>
lase	<leɪz>
nome	<noʊm>
dahl	<dɑl>
yard	<jɑrd>
buc	<bək>
tight	<taɪt>
wrist	<rɪst>
rud	<rəd>
bends	<bɛndz>
frog	<frɑg>
watch	<wɔʧ>
perk	<pərk>
stay	<steɪ>
ploy	<plɔɪ>
loaf	<loʊf>
drape	<dreɪp>
crutch	<krəʧ>
bash	<bæʃ>
gird	<gərd>
caine	<keɪn>
lies	<laɪz>
awe	<ɔ>
gul	<gəl>
tress	<trɛs>
lure	<lʊr>
trot	<trɑt>
rag	<ræg>
geist	<gaɪst>
gil	<gɪl>
crest	<krɛst>
bam	<bæm>
crum	<krəm>
stall	<stɔl>
pain	<peɪn>
stops	<stɑps>
shorts	<ʃɔrts>
wad	<wɑd>
faint	<feɪnt>
tweak	<twik>
mille	<mɪl>
mule	<mjul>
wand	<wɑnd>
gens	<ʤɛnz>
dump	<dəmp>
brent	<brɛnt>
pounce	<paʊns>
film	<fɪlm>
while	<waɪl>
scene	<sin>
sides	<saɪdz>
coal	<koʊl>
sprint	<sprɪnt>
slay	<sleɪ>
look	<lʊk>
splits	<splɪts>
foal	<foʊl>
bore	<bɔr>
reave	<riv>
inch	<ɪnʧ>
matt	<mæt>
berg	<bərg>
spare	<spɛr>
boat	<boʊt>
carte	<kɑrt>
amp	<æmp>
crom	<krɑm>
curl	<kərl>
reap	<rip>
sect	<sɛkt>
lute	<lut>
mens	<mɛnz>
lapse	<læps>
size	<saɪz>
selves	<sɛlvz>
cock	<kɑk>
tuck	<tək>
sten	<stɛn>
leas	<liz>
coin	<kɔɪn>
fen	<fɛn>
heed	<hid>
drunk	<drəŋk>
block	<blɑk>
fuel	<fjuəl>
gap	<gæp>
rick	<rɪk>
stare	<stɛr>
jack	<ʤæk>
ass	<æs>
loy	<lɔɪ>
cheque	<ʧɛk>
thirst	<θərst>
rem	<rɛm>
throat	<θroʊt>
ceased	<sist>
thread	<θrɛd>
bide	<baɪd>
mom	<mɑm>
too	<tu>
pork	<pɔrk>
len	<lɛn>
leen	<lin>
ski	<ski>
bric	<brɪk>
boll	<boʊl>
sheep	<ʃip>
script	<skrɪpt>
lad	<læd>
chained	<ʧeɪnd>
hind	<haɪnd>
tool	<tul>
pars	<pɑrz>
luc	<luk>
bare	<bɛr>
plug	<pləg>
aer	<ɛr>
bought	<bɔt>
solved	<sɑlvd>
off	<ɔf>
zan	<zæn>
swat	<swɑt>
storm	<stɔrm>
ke	<kɛ>
length	<lɛŋθ>
arched	<ɑrʧt>
deaf	<dɛf>
bag	<bæg>
keg	<kɛg>
poor	<pur>
steed	<stid>
dried	<draɪd>
dumb	<dəm>
tenth	<tɛnθ>
hell	<hɛl>
thus	<ðəs>
suck	<sək>
fick	<fɪk>
clue	<klu>
rush	<rəʃ>
ur	<ər>
damp	<dæmp>
manned	<mænd>
horned	<hɔrnd>
crack	<kræk>
cough	<kɔf>
note	<noʊt>
milk	<mɪlk>
page	<peɪʤ>
score	<skɔr>
gress	<grɛs>
vue	<vju>
cham	<ʧæm>
paign	<peɪn>
econ	<ˈiˌkɑn>
ark	<ɑrk>
grim	<grɪm>
leg	<lɛg>
jot	<ʤɑt>
strap	<stræp>
pint	<paɪnt>
haul	<hɔl>
flip	<flɪp>
gulf	<gəlf>
vogue	<voʊg>
throb	<θrɑb>
bing	<bɪŋ>
blonde	<blɑnd>
pang	<pæŋ>
fox	<fɑks>
pinch	<pɪnʧ>
sap	<sæp>
brick	<brɪk>
sole	<soʊl>
lain	<leɪn>
bue	<bwɛ>
lag	<læg>
bouts	<baʊts>
lined	<laɪnd>
dia	<ˈdiə>
slug	<sləg>
gish	<ʤɪʃ>
kitch	<kɪʧ>
romp	<rɑmp>
tram	<træm>
string	<strɪŋ>
slave	<sleɪv>
starve	<stɑrv>
daw	<dɔ>
jun	<ʤən>
quilt	<kwɪlt>
dire	<daɪər>
rough	<rəf>
wire	<waɪər>
phar	<fɑr>
ply	<plaɪ>
dour	<daʊər>
glass	<glæs>
redd	<rɛd>
gab	<gæb>
made	<meɪd>
dead	<dɛd>
knee	<ni>
hump	<həmp>
kind	<kaɪnd>
dred	<drɛd>
youth	<juθ>
feed	<fid>
twill	<twɪl>
sight	<saɪt>
flak	<flæk>
asp	<æsp>
sconce	<skɑns>
tass	<tæs>
crush	<krəʃ>
jean	<ʤin>
cache	<kæˈʃeɪ>
lol	<lɔl>
boon	<bun>
splat	<splæt>
pad	<pæd>
plump	<pləmp>
black	<blæk>
tiff	<tɪf>
frith	<frɪθ>
has	<həz>
wis	<wɪs>
rape	<reɪp>
snuff	<snəf>
plush	<pləʃ>
heir	<ɛr>
rio	<ˈrioʊ>
chae	<ʧaɪ>
huff	<həf>
fond	<fɑnd>
beth	<bɛθ>
cave	<keɪv>
gore	<gɔr>
peer	<pɪr>
roost	<rust>
shoe	<ʃu>
zel	<zɛl>
dick	<dɪk>
mains	<meɪnz>
root	<rut>
bell	<bɛl>
ranged	<reɪnʤd>
stale	<steɪl>
our	<ɑr>
hat	<hæt>
loathe	<loʊð>
lum	<ləm>
kon	<kɑn>
lye	<laɪ>
vice	<vaɪs>
viv	<vɪv>
nile	<naɪl>
fact	<fækt>
brows	<braʊz>
than	<ðən>
hick	<hɪk>
theirs	<ðɛrz>
may	<meɪ>
stance	<stæns>
yo	<joʊ>
thrice	<θraɪs>
baa	<ˌbiˌeɪˈeɪ>
carve	<kɑrv>
reach	<riʧ>
snap	<snæp>
touched	<təʧt>
sans	<sænz>
wale	<weɪl>
rows	<roʊz>
grass	<græs>
rasp	<ræsp>
end	<ɛnd>
strung	<strəŋ>
dar	<dɑr>
harm	<hɑrm>
text	<tɛkst>
pour	<pɔr>
slaugh	<slɔ>
kyle	<kaɪl>
race	<reɪs>
list	<lɪst>
scram	<skræm>
thun	<θən>
lets	<lɛts>
crime	<kraɪm>
repr	<ˈrɛpər>
slate	<sleɪt>
gull	<gəl>
cue	<kju>
swell	<swɛl>
shirt	<ʃərt>
treat	<trit>
march	<mɑrʧ>
scrap	<skræp>
hinge	<hɪnʤ>
deft	<dɛft>
roof	<rʊf>
riff	<rɪf>
fowl	<faʊl>
cringe	<krɪnʤ>
thrive	<θraɪv>
haus	<haʊs>
dix	<dɪks>
crose	<kroʊz>
jaws	<ʤɔz>
fucking	<ˈfəkɪŋ>
wrote	<roʊt>
flee	<fli>
mei	<meɪ>
wed	<wɛd>
over	<ˈoʊvər>
cold	<koʊld>
bring	<brɪŋ>
shrink	<ʃrɪŋk>
suds	<sədz>
give	<gɪv>
craps	<kræps>
ros	<rɔs>
grain	<greɪn>
dah	<də>
tear	<tɪr>
calm	<kɑm>
junk	<ʤəŋk>
lem	<lɛm>
sculpt	<skəlpt>
boss	<bɔs>
moor	<mʊr>
boule	<bul>
lash	<læʃ>
crisp	<krɪsp>
thong	<θɔŋ>
freight	<freɪt>
stem	<stɛm>
tsar	<zɑr>
cash	<kæʃ>
hast	<hæst>
braced	<breɪst>
sail	<seɪl>
rule	<rul>
chaps	<ʧæps>
gasp	<gæsp>
ringe	<rɪŋ>
kun	<kən>
vile	<vaɪl>
mich	<mɪʧ>
stade	<steɪd>
brack	<bræk>
scor	<skɔr>
crew	<kru>
crate	<kreɪt>
scan	<skæn>
mite	<maɪt>
twelve	<twɛlv>
wart	<wɔrt>
quant	<kwænt>
woods	<wʊdz>
fad	<fæd>
had	<hæd>
sword	<sɔrd>
soot	<sʊt>
wired	<waɪərd>
jess	<ʤɛs>
cole	<koʊl>
heard	<hərd>
bro	<broʊ>
scoot	<skut>
mick	<mɪk>
tick	<tɪk>
digs	<dɪgz>
grave	<greɪv>
roque	<roʊk>
fill	<fɪl>
ride	<raɪd>
wolf	<wʊlf>
nuke	<nuk>
bom	<bɑm>
reck	<rɛk>
yen	<jɛn>
cairn	<kɛrn>
trip	<trɪp>
slam	<slæm>
ill	<ɪl>
zine	<zaɪn>
chaff	<ʧæf>
scored	<skɔrd>
earth	<ərθ>
vise	<vaɪs>
ins	<ˈaɪˈɛˈnɛs>
mold	<moʊld>
skid	<skɪd>
grieved	<grivd>
dole	<doʊl>
took	<tʊk>
church	<ʧərʧ>
stage	<steɪʤ>
chon	<ʧɑn>
weld	<wɛld>
canned	<kænd>
taj	<tɑʒ>
skew	<skju>
helm	<hɛlm>
viar	<vaɪər>
lest	<lɛst>
full	<fʊl>
dogs	<dɔgz>
jin	<ʤɪn>
tempt	<tɛmpt>
nope	<noʊp>
squad	<skwɑd>
boot	<but>
won	<wən>
route	<rut>
lage	<leɪʤ>
blink	<blɪŋk>
swarm	<swɔrm>
style	<staɪl>
jerk	<ʤərk>
fifth	<fɪθ>
joint	<ʤɔɪnt>
hunch	<hənʧ>
truss	<trəs>
plead	<plid>
rub	<rəb>
quits	<kwɪts>
boar	<bɔr>
bless	<blɛs>
still	<stɪl>
mayor	<meɪər>
sweeps	<swips>
scout	<skaʊt>
linn	<lɪn>
cott	<kɑt>
biz	<bɪz>
hou	<hu>
p	<pi>
shave	<ʃeɪv>
earl	<ərl>
smashed	<smæʃt>
pac	<pæk>
noons	<nunz>
kilt	<kɪlt>
vox	<vɑks>
pied	<paɪd>
piled	<paɪld>
chit	<ʧɪt>
vamp	<væmp>
brake	<breɪk>
brain	<breɪn>
kill	<kɪl>
rail	<reɪl>
feel	<fil>
mong	<mɔŋ>
grieve	<griv>
flop	<flɑp>
knock	<nɑk>
bind	<baɪnd>
gnome	<noʊm>
theft	<θɛft>
chest	<ʧɛst>
sponge	<spənʤ>
rein	<reɪn>
deer	<dɪr>
shade	<ʃeɪd>
rey	<reɪ>
debt	<dɛt>
goose	<gus>
drive	<draɪv>
feit	<faɪt>
cree	<kri>
lode	<loʊd>
dirk	<dərk>
sky	<skaɪ>
iq	<ˈaɪˈkju>
heft	<hɛft>
vow	<vaʊ>
chew	<ʧu>
fives	<faɪvz>
lang	<læŋ>
girth	<gərθ>
burr	<bər>
maze	<meɪz>
strut	<strət>
ooh	<u>
clack	<klæk>
beach	<biʧ>
nath	<næθ>
tubes	<tubz>
bour	<baʊr>
moot	<mut>
plane	<pleɪn>
chuck	<ʧək>
hedge	<hɛʤ>
mired	<maɪrd>
have	<hæv>
eat	<it>
scoop	<skup>
how	<haʊ>
wing	<wɪŋ>
dodge	<dɑʤ>
sparse	<spɑrs>
pate	<peɪt>
hears	<hirz>
bach	<bɑk>
flick	<flɪk>
valve	<vælv>
motte	<mɑt>
roach	<roʊʧ>
kir	<kɪr>
orb	<ɔrb>
whey	<weɪ>
whom	<hum>
claimed	<kleɪmd>
champ	<ʧæmp>
sir	<sər>
biff	<bɪf>
hilt	<hɪlt>
yours	<jʊrz>
durst	<dərst>
cob	<kɑb>
webs	<wɛbz>
suave	<swɑv>
are	<ər>
wrath	<ræθ>
chris	<krɪs>
term	<tərm>
crick	<krɪk>
glimpse	<glɪmps>
mee	<mi>
vex	<vɛks>
spy	<spaɪ>
alms	<ɑmz>
deb	<dɛb>
lamb	<læm>
core	<kɔr>
nerve	<nərv>
bade	<beɪd>
desk	<dɛsk>
slap	<slæp>
rance	<ræns>
balk	<bɔk>
sane	<seɪn>
fund	<fənd>
would	<wʊd>
spank	<spæŋk>
goo	<gu>
bulk	<bəlk>
spike	<spaɪk>
traps	<træps>
been	<bɪn>
depth	<dɛpθ>
cult	<kəlt>
ast	<æst>
alpha	<ˈælfə>
numeric	<nuˈmɛrɪk>
tense	<tɛns>
conte	<ˈkɔnteɪ>
rak	<ræk>
lung	<ləŋ>
gray	<greɪ>
bahn	<bæn>
vers	<vərs>
juice	<ʤus>
loo	<lu>
brood	<brud>
ranked	<ræŋkt>
tart	<tɑrt>
ways	<weɪz>
ear	<ɪr>
nest	<nɛst>
hone	<hoʊn>
raf	<ræf>
grouse	<graʊs>
math	<mæθ>
link	<lɪŋk>
germ	<ʤərm>
esque	<ɛsk>
sling	<slɪŋ>
grab	<græb>
kirk	<kərk>
cards	<kɑrdz>
shy	<ʃaɪ>
rex	<rɛks>
bass	<bæs>
belle	<bɛl>
foss	<fɑs>
slack	<slæk>
grid	<grɪd>
fab	<fæb>
sie	<si>
stice	<staɪs>
galax	<ˈgæˌlæks>
oak	<oʊk>
flock	<flɑk>
sod	<sɑd>
parch	<pɑrʧ>
clum	<kləm>
hoist	<hɔɪst>
chomp	<ʧɑmp>
smell	<smɛl>
mime	<maɪm>
glide	<glaɪd>
slit	<slɪt>
ruse	<ruz>
hands	<hænz>
bats	<bæts>
guns	<gənz>
source	<sɔrs>
ray	<reɪ>
eccles	<ˈɛkəlz>
cleans	<klinz>
cinque	<sɪŋk>
threat	<θrɛt>
woo	<wu>
wheat	<wit>
boiled	<bɔɪld>
nau	<noʊ>
flax	<flæks>
swain	<sweɪn>
dale	<deɪl>
change	<ʧeɪnʤ>
taps	<tæps>
trail	<treɪl>
hep	<hɛp>
fame	<feɪm>
pun	<pən>
quite	<kwaɪt>
drank	<dræŋk>
meet	<mit>
nir	<nɪr>
fuzz	<fəz>
bald	<bɔld>
spread	<sprɛd>
buy	<baɪ>
mood	<mud>
cram	<kræm>
hog	<hɑg>
tied	<taɪd>
blitz	<blɪts>
krieg	<krig>
muse	<mjuz>
hogg	<hɑg>
whet	<wɛt>
lech	<lɛk>
elf	<ɛlf>
leave	<liv>
raid	<reɪd>
snipe	<snaɪp>
bold	<boʊld>
duke	<duk>
och	<ɑk>
sate	<seɪt>
tree	<tri>
fade	<feɪd>
crass	<kræs>
cox	<kɑks>
drapes	<dreɪps>
lens	<lɛnz>
zant	<zænt>
braid	<breɪd>
tsu	<tsu>
dean	<din>
mauve	<mɔv>
wild	<waɪld>
pared	<pɛrd>
bruise	<bruz>
pont	<pɑnt>
dug	<dəg>
palm	<pɑm>
grove	<groʊv>
lube	<lub>
hook	<hʊk>
fleer	<flɪr>
heck	<hɛk>
till	<tɪl>
smith	<smɪθ>
smoke	<smoʊk>
fig	<fɪg>
zon	<zɔn>
stakes	<steɪks>
glow	<gloʊ>
hah	<hɑ>
merce	<mərs>
witch	<wɪʧ>
lance	<læns>
toll	<toʊl>
fake	<feɪk>
vist	<vɪst>
dial	<daɪəl>
sow	<soʊ>
wack	<wæk>
pitch	<pɪʧ>
birth	<bərθ>
sharp	<ʃɑrp>
say	<seɪ>
jazz	<ʤæz>
lege	<liʤ>
lide	<laɪd>
noun	<naʊn>
yeast	<jist>
parts	<pɑrts>
cia	<siaɪeɪ>
stake	<steɪk>
bes	<biz>
shelf	<ʃɛlf>
hough	<həf>
curt	<kərt>
since	<sɪns>
fixed	<fɪkst>
strength	<strɛŋθ>
poet	<poʊət>
hearse	<hərs>
goat	<goʊt>
ian	<ˈiən>
guise	<gaɪz>
foy	<fɔɪ>
bars	<bɑrz>
maj	<mæʤ>
clay	<kleɪ>
ord	<ɔrd>
thou	<ðaʊ>
hive	<haɪv>
stab	<stæb>
dai	<daɪ>
ruth	<ruθ>
glade	<gleɪd>
fling	<flɪŋ>
pooh	<pu>
guide	<gaɪd>
forte	<ˈfɔrteɪ>
rice	<raɪs>
bough	<baʊ>
sheath	<ʃiθ>
gift	<gɪft>
loin	<lɔɪn>
marge	<mɑrʤ>
chip	<ʧɪp>
mouse	<maʊs>
noise	<nɔɪz>
fritz	<frɪts>
weep	<wip>
coax	<koʊks>
grudge	<grəʤ>
swear	<swɛr>
arse	<ɑrs>
roy	<rɔɪ>
nosed	<noʊzd>
kane	<keɪn>
bleep	<blip>
metal	<ˈmɛtəl>
prick	<prɪk>
prowl	<praʊl>
hearts	<hɑrts>
bea	<bi>
tug	<təg>
musk	<məsk>
jab	<ʤæb>
flown	<floʊn>
flange	<flænʤ>
peach	<piʧ>
jolt	<ʤoʊlt>
shan	<ʃæn>
ought	<ɔt>
fell	<fɛl>
ghost	<goʊst>
done	<dən>
lend	<lɛnd>
hour	<aʊər>
mull	<məl>
once	<wəns>
yaw	<jɔ>
vy	<vaɪ>
phan	<fæn>
proud	<praʊd>
s	<ɛs>
kyl	<kaɪl>
lex	<lɛks>
dink	<dɪŋk>
ade	<eɪd>
zi	<zi>
blank	<blæŋk>
talc	<tælk>
splice	<splaɪs>
jock	<ʤɑk>
comp	<kɑmp>
swab	<swɑb>
wide	<waɪd>
plant	<plænt>
phase	<feɪz>
crane	<kreɪn>
bund	<bənd>
robe	<roʊb>
null	<nəl>
zing	<zɪŋ>
spear	<spɪr>
feat	<fit>
budge	<bəʤ>
trim	<trɪm>
couch	<kaʊʧ>
lamp	<læmp>
grow	<groʊ>
gland	<glænd>
bask	<bæsk>
move	<muv>
mize	<maɪz>
bone	<boʊn>
we	<wi>
raine	<reɪn>
morph	<mɔrf>
barred	<bɑrd>
zoom	<zum>
hemo	<ˈhimoʊ>
rove	<roʊv>
mass	<mæs>
joe	<ʤoʊ>
host	<hoʊst>
sot	<sɔt>
pipe	<paɪp>
wink	<wɪŋk>
bright	<braɪt>
leech	<liʧ>
thug	<θəg>
sock	<sɑk>
poke	<poʊk>
lope	<loʊp>
hoop	<hup>
rite	<raɪt>
spay	<speɪ>
lour	<laʊr>
fried	<frid>
flor	<flɔr>
prus	<prəs>
square	<skwɛr>
norm	<nɔrm>
know	<noʊ>
tip	<tɪp>
truck	<trək>
sheik	<ʃik>
peep	<pip>
burst	<bərst>
lone	<loʊn>
meg	<mɛg>
worth	<wərθ>
brit	<brɪt>
curse	<kərs>
quiche	<kiʃ>
flare	<flɛr>
risk	<rɪsk>
fine	<faɪn>
learn	<lərn>
eon	<iɑn>
crosse	<krɑs>
whites	<waɪts>
frau	<fraʊ>
trash	<træʃ>
chalk	<ʧɔk>
trick	<trɪk>
fry	<fraɪ>
eb	<ɛb>
borne	<bɔrn>
pew	<pju>
jet	<ʤɛt>
quipped	<kwɪpt>
shift	<ʃɪft>
steel	<stil>
plume	<plum>
ji	<ʤi>
phrase	<freɪz>
anal	<ˈeɪnəl>
swung	<swəŋ>
colo	<ˈkoʊloʊ>
rent	<rɛnt>
verge	<vərʤ>
lade	<leɪd>
fright	<fraɪt>
farce	<fɑrs>
flaw	<flɔ>
clothe	<kloʊð>
coz	<kɑz>
chart	<ʧɑrt>
whilst	<waɪlst>
ku	<ku>
mush	<məʃ>
dine	<daɪn>
weir	<wir>
bred	<brɛd>
moi	<mwɑ>
selle	<sɛl>
yew	<ju>
scribe	<skraɪb>
hung	<həŋ>
tex	<tɛks>
thaw	<θɔ>
tome	<toʊm>
states	<steɪts>
throes	<θroʊz>
owl	<aʊl>
pole	<poʊl>
squeeze	<skwiz>
smug	<sməg>
though	<ðoʊ>
flesh	<flɛʃ>
this	<ðɪs>
erb	<ərb>
sperm	<spərm>
huh	<hə>
slut	<slət>
rake	<reɪk>
jig	<ʤɪg>
spit	<spɪt>
voice	<vɔɪs>
pissed	<pɪst>
pier	<pɪr>
freak	<frik>
wall	<wɔl>
stocks	<stɑks>
plow	<plaʊ>
ay	<eɪ>
hose	<hoʊz>
tew	<tu>
sens	<sɛnz>
cloak	<kloʊk>
numb	<nəm>
crump	<krəmp>
stink	<stɪŋk>
dumps	<dəmps>
trunks	<trəŋks>
haze	<heɪz>
hull	<həl>
patched	<pæʧt>
felt	<fɛlt>
tomb	<tum>
scroll	<skroʊl>
pants	<pænts>
stacked	<stækt>
rears	<rɪrz>
bout	<baʊt>
peek	<pik>
stomp	<stɑmp>
words	<wərdz>
spell	<spɛl>
bleed	<blid>
fey	<feɪ>
kept	<kɛpt>
lisp	<lɪsp>
dish	<dɪʃ>
jug	<ʤəg>
wee	<wi>
nie	<ni>
dill	<dɪl>
hund	<hənd>
jay	<ʤeɪ>
fizz	<fɪz>
owe	<oʊ>
ruin	<ruɪn>
butte	<bjut>
ripe	<raɪp>
small	<smɔl>
pox	<pɑks>
noe	<noʊ>
wool	<wʊl>
noir	<nɔɪr>
tribe	<traɪb>
rouse	<raʊz>
scotch	<skɑʧ>
rand	<rænd>
served	<sərvd>
psych	<saɪk>
kraft	<kræft>
griz	<grɪz>
milled	<mɪld>
brute	<brut>
gloss	<glɔs>
ane	<æn>
caste	<kæst>
rise	<raɪz>
quit	<kwɪt>
soap	<soʊp>
nab	<næb>
grease	<gris>
all	<ɔl>
gems	<ʤɛmz>
smack	<smæk>
breadth	<brɛdθ>
stove	<stoʊv>
yu	<ju>
greed	<grid>
dove	<dəv>
sly	<slaɪ>
heat	<hit>
slab	<slæb>
squid	<skwɪd>
lush	<ləʃ>
opp	<ɑp>
flank	<flæŋk>
woe	<woʊ>
sift	<sɪft>
neat	<nit>
bounds	<baʊndz>
dock	<dɑk>
posh	<pɑʃ>
winged	<wɪŋd>
serge	<sərʤ>
brought	<brɔt>
coil	<kɔɪl>
petrol	<ˈpɛtroʊl>
caped	<keɪpt>
mound	<maʊnd>
shack	<ʃæk>
psalm	<sɑm>
lath	<læθ>
tuff	<təf>
should	<ʃʊd>
d	<di>
tights	<taɪts>
clump	<kləmp>
bent	<bɛnt>
steels	<stilz>
feld	<fɛld>
spar	<spɑr>
toe	<toʊ>
kohl	<koʊl>
froth	<frɔθ>
parse	<pɑrs>
maul	<mɔl>
ziff	<zɪf>
mess	<mɛs>
shi	<ʃi>
slow	<sloʊ>
whiz	<wɪz>
trey	<treɪ>
cale	<keɪl>
muck	<mək>
wy	<weɪ>
vern	<vərn>
leaf	<lif>
lair	<lɛr>
smut	<smət>
liar	<laɪər>
balls	<bɔlz>
beep	<bip>
nail	<neɪl>
flea	<fli>
bauch	<bɔʧ>
lunch	<lənʧ>
split	<splɪt>
mig	<mɪg>
coke	<koʊk>
worn	<wɔrn>
lei	<leɪ>
dac	<dæk>
oust	<aʊst>
slurp	<slərp>
gaze	<geɪz>
crown	<kraʊn>
haunt	<hɔnt>
loop	<lup>
bead	<bid>
sleeps	<slips>
jog	<ʤɑg>
brink	<brɪŋk>
lived	<lɪvd>
swift	<swɪft>
vorce	<vɔrs>
raw	<rɑ>
clef	<klɛf>
tiled	<taɪld>
melt	<mɛlt>
golf	<gɔlf>
meld	<mɛld>
cruise	<kruz>
dutch	<dəʧ>
tier	<tir>
spitz	<spɪts>
spoke	<spoʊk>
dag	<dæg>
patch	<pæʧ>
downs	<daʊnz>
teer	<tɪr>
cool	<kul>
grew	<gru>
bak	<bæk>
zelle	<zɛl>
raced	<reɪst>
lull	<ləl>
swig	<swɪg>
tide	<taɪd>
veer	<vɪr>
fuse	<fjuz>
via	<ˈviə>
roam	<roʊm>
ail	<eɪl>
soup	<sup>
cued	<kjud>
did	<dɪd>
plod	<plɑd>
leapt	<lɛpt>
rags	<rægz>
scab	<skæb>
tai	<taɪ>
dote	<doʊt>
birch	<bərʧ>
swept	<swɛpt>
hoarse	<hɔrs>
dime	<daɪm>
hub	<həb>
zig	<zɪg>
zag	<zæg>
boost	<bust>
sak	<sæk>
rouge	<ruʒ>
luse	<luz>
pleat	<plit>
splash	<splæʃ>
moss	<mɔs>
slide	<slaɪd>
flamed	<fleɪmd>
strang	<stræŋ>
ole	<ˌoʊˈleɪ>
sang	<sæŋ>
stew	<stu>
screw	<skru>
rums	<rəmz>
als	<ælz>
grip	<grɪp>
cede	<sid>
hew	<hju>
loos	<luz>
chin	<ʧɪn>
fuck	<fək>
twined	<twaɪnd>
crouch	<kraʊʧ>
bish	<bɪʃ>
worked	<wərkt>
screwed	<skrud>
scale	<skeɪl>
cong	<kɔŋ>
whiff	<wɪf>
wound	<wund>
fierce	<fɪrs>
maw	<mɔ>
fop	<ˈɛˈfoʊˈpi>
yup	<jəp>
filled	<fɪld>
spat	<spæt>
slid	<slɪd>
swish	<swɪʃ>
rhyme	<raɪm>
mode	<moʊd>
chic	<ʃik>
mont	<mɑnt>
spurred	<spərd>
waugh	<wɔ>
kent	<kɛnt>
mere	<mɪr>
clips	<klɪps>
lodge	<lɑʤ>
steal	<stil>
juke	<ʤuk>
fats	<fæts>
quark	<kwɑrk>
nil	<nɪl>
bott	<bɑt>
nix	<nɪks>
hue	<hju>
peas	<piz>
dome	<doʊm>
grasp	<græsp>
bail	<beɪl>
blurb	<blərb>
honk	<hɔŋk>
prim	<prɪm>
beau	<boʊ>
stray	<streɪ>
sip	<sɪp>
brunt	<brənt>
snot	<snɔt>
nude	<nud>
pru	<pru>
wept	<wɛpt>
sund	<sənd>
heit	<haɪt>
ode	<oʊd>
such	<səʧ>
stoop	<stup>
nose	<noʊz>
prompt	<prɑmpt>
cask	<kæsk>
join	<ʤɔɪn>
diced	<daɪst>
churn	<ʧərn>
laps	<læps>
luce	<lus>
notes	<noʊts>
verve	<vərv>
wit	<wɪt>
dear	<dɪr>
glare	<glɛr>
coat	<koʊt>
sore	<sɔr>
cowl	<kaʊl>
write	<raɪt>
midst	<mɪst>
cooked	<kʊkt>
joule	<ʤul>
cray	<kreɪ>
hart	<hɑrt>
spine	<spaɪn>
ip	<ˌaɪˌpi>
oft	<ɔft>
tie	<taɪ>
yon	<jɑn>
yah	<jɑ>
clash	<klæʃ>
slung	<sləŋ>
white	<waɪt>
gib	<gɪb>
nymph	<nɪmf>
kiss	<kɪs>
forced	<fɔrst>
dee	<di>
dense	<dɛns>
loose	<lus>
wold	<woʊld>
bush	<bʊʃ>
shaped	<ʃeɪpt>
fail	<feɪl>
cite	<saɪt>
twitch	<twɪʧ>
teeth	<tiθ>
shrunk	<ʃrəŋk>
mint	<mɪnt>
eats	<its>
rhine	<raɪn>
vibes	<vaɪbz>
cords	<kɔrdz>
perse	<pərs>
nth	<ɛnθ>
soy	<sɔɪ>
whim	<wɪm>
lene	<lin>
stork	<stɔrk>
fret	<frɛt>
mea	<mi>
stunt	<stənt>
twice	<twaɪs>
carp	<kɑrp>
cheek	<ʧik>
aim	<eɪm>
dyke	<daɪk>
typo	<ˈtaɪpoʊ>
cates	<keɪts>
bunt	<bənt>
hence	<hɛns>
sniff	<snɪf>
boil	<bɔɪl>
jail	<ʤeɪl>
fetch	<fɛʧ>
thumb	<θəm>
tye	<taɪ>
corps	<kɔrz>
pure	<pjʊr>
surge	<sərʤ>
coo	<ku>
scalp	<skælp>
criss	<krɪs>
coast	<koʊst>
nib	<nɪb>
dune	<dun>
smit	<smɪt>
praise	<preɪz>
cunt	<kənt>
slash	<slæʃ>
worm	<wərm>
these	<ðiz>
ost	<oʊst>
torque	<tɔrk>
bran	<bræn>
lane	<leɪn>
locks	<lɑks>
sheer	<ʃɪr>
mouth	<maʊθ>
praised	<preɪzd>
tad	<tæd>
sledge	<slɛʤ>
stilled	<stɪld>
hoax	<hoʊks>
sing	<sɪŋ>
bey	<beɪ>
ville	<vɪl>
stool	<stul>
dart	<dɑrt>
grit	<grɪt>
trace	<treɪs>
mask	<mæsk>
berth	<bərθ>
niche	<nɪʧ>
darn	<dɑrn>
slept	<slɛpt>
cyst	<sɪst>
nast	<næst>
stack	<stæk>
starch	<stɑrʧ>
tyre	<taɪər>
riel	<ril>
jim	<ʤɪm>
elk	<ɛlk>
khan	<kɑn>
typed	<taɪpt>
streak	<strik>
young	<jəŋ>
jake	<ʤeɪk>
knoll	<noʊl>
byte	<baɪt>
trout	<traʊt>
evan	<ˈɛvən>
laird	<lɛrd>
paste	<peɪst>
wage	<weɪʤ>
whips	<wɪps>
bub	<bəb>
mutt	<mət>
sieve	<sɪv>
disc	<dɪsk>
prong	<prɔŋ>
dearth	<dərθ>
finance	<ˈfaɪˌnæns>
chain	<ʧeɪn>
stant	<stænt>
swan	<swɔn>
clip	<klɪp>
crossed	<krɔst>
cart	<kɑrt>
duch	<dəʧ>
burl	<bərl>
cass	<kæs>
wares	<wɛrz>
grout	<graʊt>
thump	<θəmp>
choke	<ʧoʊk>
shin	<ʃɪn>
skirt	<skərt>
ye	<jɛ>
cork	<kɔrk>
sleek	<slik>
lots	<lɑts>
myrrh	<mər>
yes	<jɛs>
brig	<brɪg>
dier	<diər>
brawl	<brɔl>
brac	<bræk>
ann	<æn>
thrown	<θroʊn>
chill	<ʧɪl>
blame	<bleɪm>
shroud	<ʃraʊd>
brut	<brut>
pest	<pɛst>
lotte	<lɑt>
sprock	<sprɑk>
hecht	<hɛkt>
own	<oʊn>
pluck	<plək>
crowned	<kraʊnd>
blade	<bleɪd>
stout	<staʊt>
que	<kju>
beard	<bɪrd>
toms	<tɑmz>
dash	<dæʃ>
jai	<ʤaɪ>
whose	<huz>
blaze	<bleɪz>
hike	<haɪk>
brand	<brænd>
yap	<jæp>
tang	<tɑŋ>
fog	<fɔg>
dain	<deɪn>
sunk	<səŋk>
gnu	<nu>
sucks	<səks>
horst	<hɔrst>
spawn	<spɔn>
lord	<lɔrd>
mop	<mɑp>
dies	<daɪz>
tess	<tɛs>
moist	<mɔɪst>
tigue	<tig>
super	<ˈsupər>
four	<fɔr>
sai	<ˈɛˈseɪˈaɪ>
hark	<hɑrk>
drown	<draʊn>
lass	<læs>
belch	<bɛlʧ>
times	<taɪmz>
moved	<muvd>
binge	<bɪnʤ>
gauze	<gɔz>
matte	<mæt>
brill	<brɪl>
ritz	<rɪts>
lowe	<loʊ>
raked	<reɪkt>
troll	<troʊl>
north	<nɔrθ>
quip	<kwɪp>
sphere	<sfɪr>
eaves	<ivz>
blocked	<blɑkt>
sworn	<swɔrn>
bong	<bɑŋ>
wane	<weɪn>
salve	<sɑv>
drudge	<drəʤ>
best	<bɛst>
bride	<braɪd>
groom	<grum>
grained	<greɪnd>
bard	<bɑrd>
shears	<ʃirz>
shape	<ʃeɪp>
tired	<taɪərd>
throng	<θrɔŋ>
blah	<blɑ>
beige	<beɪʒ>
mead	<mid>
dae	<deɪ>
mance	<mæns>
clique	<klik>
dreamt	<drɛmt>
bos	<bɑs>
pops	<pɑps>
roc	<rɑk>
tue	<tu>
piss	<pɪs>
trench	<trɛnʧ>
fluent	<fluənt>
tod	<tɑd>
sash	<sæʃ>
rude	<rud>
rog	<rɑg>
howl	<haʊl>
sain	<seɪn>
ike	<aɪk>
cad	<kæd>
loge	<loʊʤ>
poss	<pɔs>
bike	<baɪk>
skinned	<skɪnd>
grump	<grəmp>
stopped	<stɑpt>
shire	<ʃaɪr>
stung	<stəŋ>
broc	<brɑk>
cuffs	<kəfs>
slop	<slɑp>
sire	<saɪər>
knick	<nɪk>
mers	<mərz>
phage	<feɪʤ>
pense	<pɛns>
noon	<nun>
ary	<ˈɛri>
shew	<ʃu>
brunch	<brənʧ>
lick	<lɪk>
chick	<ʧɪk>
spice	<spaɪs>
leath	<liθ>
queer	<kwɪr>
tape	<teɪp>
tosh	<tɑʃ>
poise	<pɔɪz>
played	<pleɪd>
few	<fju>
sprang	<spræŋ>
sway	<sweɪ>
toad	<toʊd>
quoth	<kwoʊθ>
batch	<bæʧ>
gall	<gɔl>
squash	<skwɑʃ>
clown	<klaʊn>
damn	<dæm>
pam	<pæm>
snore	<snɔr>
wheels	<wilz>
crud	<krəd>
strained	<streɪnd>
named	<neɪmd>
clutch	<kləʧ>
speak	<spik>
flask	<flæsk>
flour	<flaʊər>
thorpe	<θɔrp>
oil	<ɔɪl>
rau	<raʊ>
sweat	<swɛt>
itch	<ɪʧ>
zarre	<ˈzɑri>
john	<ʤɑn>
starred	<stɑrd>
shep	<ʃɛp>
cussed	<kəst>
whoop	<wup>
tweed	<twid>
moll	<mɑl>
shek	<ʃɛk>
rear	<rɪr>
lew	<lu>
trump	<trəmp>
spool	<spul>
vang	<væŋ>
hob	<hɑb>
lynx	<lɪŋks>
boom	<bum>
ang	<æŋ>
goes	<goʊz>
prince	<prɪns>
bans	<bænz>
cac	<ˈsiˈeɪˈsi>
scream	<skrim>
clipped	<klɪpt>
sprite	<spraɪt>
cans	<kænz>
lapsed	<læpst>
cose	<koʊz>
lai	<laɪ>
gash	<gæʃ>
pulse	<pəls>
specs	<spɛks>
rave	<reɪv>
scheme	<skim>
keck	<kɛk>
tarp	<tɑrp>
bourne	<bɔrn>
bulge	<bəlʤ>
shake	<ʃeɪk>
tramp	<træmp>
puff	<pəf>
soon	<sun>
stain	<steɪn>
dall	<dɔl>
grill	<grɪl>
graft	<græft>
scant	<skænt>
drag	<dræg>
tongues	<təŋz>
gourd	<gɔrd>
went	<wɛnt>
cub	<kəb>
punt	<pənt>
sleeve	<sliv>
laud	<lɔd>
elm	<ɛlm>
spook	<spuk>
strate	<streɪt>
tote	<toʊt>
dank	<dæŋk>
banks	<bæŋks>
dusk	<dəsk>
morgue	<mɔrg>
swoon	<swun>
nett	<nɛt>
eel	<il>
lists	<lɪsts>
sank	<sæŋk>
known	<noʊn>
jesse	<ˈʤɛsi>
ugh	<əg>
rim	<rɪm>
browse	<braʊz>
fob	<fɔb>
bunk	<bəŋk>
steen	<stin>
jeans	<ʤinz>
gauche	<goʊʃ>
fled	<flɛd>
fro	<froʊ>
rare	<rɛr>
fuss	<fəs>
yacht	<jɑt>
snout	<snaʊt>
clerk	<klərk>
steak	<steɪk>
vouch	<vaʊʧ>
kash	<kæʃ>
blamed	<bleɪmd>
tamed	<teɪmd>
oi	<ɔɪ>
hut	<hət>
kling	<klɪŋ>
clan	<klæn>
snort	<snɔrt>
raged	<reɪʤd>
blush	<bləʃ>
ltd	<ˈɛlˈtiˈdi>
darned	<dɑrnd>
maize	<meɪz>
pry	<praɪ>
trude	<trud>
bloat	<bloʊt>
firth	<fərθ>
slope	<sloʊp>
swank	<swæŋk>
else	<ɛls>
plum	<pləm>
harp	<hɑrp>
elect	<ɪˈlɛkt>
lurk	<lərk>
vale	<veɪl>
psi	<saɪ>
stokes	<stoʊks>
fessed	<fɛst>
concur	<kənˈkər>
glad	<glæd>
raun	<rɔn>
bleach	<bliʧ>
theme	<θim>
cage	<keɪʤ>
limp	<lɪmp>
dorm	<dɔrm>
huge	<juʤ>
chunk	<ʧəŋk>
reif	<rif>
tout	<taʊt>
screech	<skriʧ>
chaste	<ʧeɪst>
dye	<daɪ>
tele	<ˈtɛlə>
dane	<deɪn>
shrewd	<ʃrud>
skate	<skeɪt>
chute	<ʃut>
wretch	<rɛʧ>
steam	<stim>
pave	<peɪv>
wore	<wɔr>
sop	<sɑp>
rights	<raɪts>
crumbs	<krəmz>
weiss	<waɪs>
purge	<pərʤ>
slough	<sləf>
chasm	<ˈkæzəm>
lounge	<laʊnʤ>
arcs	<ɑrks>
hunks	<həŋks>
dude	<dud>
flim	<flɪm>
wield	<wild>
thinks	<θɪŋks>
maid	<meɪd>
chokes	<ʧoʊks>
chump	<ʧəmp>
buss	<bəs>
taste	<teɪst>
crap	<kræp>
pie	<paɪ>
gilt	<gɪlt>
pierce	<pɪrs>
pause	<pɔz>
swamp	<swɔmp>
came	<keɪm>
hare	<hɛr>
wives	<waɪvz>
welsh	<wɛlʧ>
r	<ɑr>
add	<æd>
caul	<kɔl>
rood	<rud>
yea	<jeɪ>
sigh	<saɪ>
two	<tu>
rug	<rəg>
stress	<strɛs>
tithe	<taɪð>
bode	<boʊd>
bags	<bægz>
smudge	<sməʤ>
zest	<zɛst>
meal	<mil>
barge	<bɑrʤ>
blur	<blər>
ties	<taɪz>
tongs	<tɔŋz>
six	<sɪks>
jan	<ʤæn>
shun	<ʃən>
toast	<toʊst>
sale	<seɪl>
barn	<bɑrn>
cull	<kəl>
temp	<tɛmp>
zil	<zɪl>
clad	<klæd>
ponce	<ˈpɑnseɪ>
gauge	<geɪʤ>
sere	<sɪr>
mall	<mɔl>
sheen	<ʃin>
reins	<reɪnz>
crea	<kri>
lame	<leɪm>
quint	<kwɪnt>
thrift	<θrɪft>
sox	<sɑks>
lsd	<ˌɛˌlɛsˈdi>
funk	<fəŋk>
eau	<oʊ>
haw	<hɔ>
mould	<moʊld>
hiss	<hɪs>
haar	<hɑr>
trade	<treɪd>
brook	<brʊk>
trance	<træns>
peg	<pɛg>
twain	<tweɪn>
limb	<lɪm>
swing	<swɪŋ>
tooth	<tuθ>
squire	<skwaɪr>
saur	<sɔr>
flew	<flu>
snoop	<snup>
skunk	<skəŋk>
toed	<toʊd>
fete	<feɪt>
wop	<wɑp>
dell	<dɛl>
shame	<ʃeɪm>
creed	<krid>
dru	<dru>
pings	<pɪŋz>
ita	<ˈaɪˈtiˈeɪ>
dupe	<dup>
seat	<sit>
nigh	<naɪ>
ake	<eɪk>
muth	<muθ>
silt	<sɪlt>
inn	<ɪn>
mobs	<mɑbz>
shim	<ʃɪm>
squat	<skwɑt>
their	<ðɛr>
shod	<ʃɑd>
wen	<wɛn>
gripe	<graɪp>
gone	<gɔn>
brin	<brɪn>
pons	<pɑnz>
quartz	<kwɔrts>
dashed	<dæʃt>
snake	<sneɪk>
does	<dɪz>
riz	<rɪz>
putt	<pət>
maes	<meɪz>
salt	<sɔlt>
cheap	<ʧip>
soar	<sɔr>
glen	<glɛn>
chance	<ʧæns>
yan	<jæn>
slice	<slaɪs>
kerb	<kərb>
geese	<gis>
mow	<moʊ>
chau	<ʃoʊ>
hoard	<hɔrd>
yearn	<jərn>
loan	<loʊn>
strom	<strɑm>
carle	<ˈkɑrəl>
deed	<did>
nights	<naɪts>
slag	<slæg>
thorn	<θɔrn>
you	<ju>
grief	<grif>
gave	<geɪv>
spas	<spɑz>
wrapped	<ræpt>
oar	<ɔr>
snatch	<snæʧ>
looped	<lupt>
pence	<pɛns>
lives	<lɪvz>
damned	<dæmd>
ich	<ɪʧ>
quail	<kweɪl>
hurl	<hərl>
veal	<vil>
heist	<haɪst>
sedge	<sɛʤ>
shout	<ʃaʊt>
mile	<maɪl>
fay	<feɪ>
pact	<pækt>
could	<kʊd>
least	<list>
phew	<fju>
mew	<mju>
dong	<dɔŋg>
knack	<næk>
clause	<klɔz>
eyre	<ɛr>
trumps	<trəmps>
brides	<braɪdz>
cobb	<kɑb>
pare	<pɛr>
spends	<spɛnz>
rudd	<rəd>
cube	<kjub>
cove	<koʊv>
drawn	<drɔn>
vane	<veɪn>
creeps	<krips>
thing	<θɪŋ>
welch	<wɛlʧ>
mumps	<məmps>
loath	<loʊθ>
queen	<kwin>
neth	<nɛθ>
doss	<dɔs>
sold	<soʊld>
vass	<væs>
brag	<bræg>
quiz	<kwɪz>
hoy	<hɔɪ>
lyre	<laɪr>
jell	<ʤɛl>
vee	<vi>
why	<waɪ>
fram	<fræm>
pane	<peɪn>
ape	<eɪp>
dore	<dɔr>
mach	<mɑk>
lark	<lɑrk>
nye	<naɪ>
garth	<gɑrθ>
mib	<mɪb>
sport	<spɔrt>
breeze	<briz>
suede	<sweɪd>
groin	<grɔɪn>
slaw	<slɔ>
shrine	<ʃraɪn>
coop	<kup>
spree	<spri>
reef	<rif>
lough	<laʊ>
sob	<sɑb>
leak	<lik>
mish	<mɪʃ>
mair	<mɛr>
quart	<kwɔrt>
chok	<ʧɑk>
corse	<kɔrs>
atm	<ˈeɪˌtiˈɛm>
fields	<fildz>
gape	<geɪp>
welt	<wɛlt>
drops	<drɑps>
cons	<kɑnz>
grum	<grəm>
doubt	<daʊt>
dawn	<dɔn>
pall	<pɔl>
jib	<ʤɪb>
dread	<drɛd>
cried	<kraɪd>
luke	<luk>
flats	<flæts>
hulk	<həlk>
mane	<meɪn>
yawn	<jɔn>
wade	<weɪd>
slav	<slɑv>
meteor	<ˈmitiər>
drain	<dreɪn>
loch	<lɑk>
ohm	<oʊm>
rink	<rɪŋk>
tint	<tɪnt>
pais	<peɪz>
coll	<kɑl>
hud	<həd>
rash	<ræʃ>
stoke	<stoʊk>
etch	<ɛʧ>
burned	<bərnd>
blew	<blu>
lais	<leɪz>
spurt	<spərt>
beef	<bif>
none	<nən>
nice	<nis>
spoof	<spuf>
nun	<nən>
winch	<wɪnʧ>
learnt	<lərnt>
gail	<geɪl>
pod	<pɑd>
eng	<ɛŋ>
stench	<stɛnʧ>
pross	<prɔs>
swore	<swɔr>
oars	<ɔrz>
ream	<rim>
lost	<lɔst>
pond	<pɑnd>
reeve	<riv>
doth	<dɔθ>
stole	<stoʊl>
steppe	<stɛp>
plight	<plaɪt>
hove	<hoʊv>
clamp	<klæmp>
stairs	<stɛrz>
duck	<dək>
scot	<skɑt>
stood	<stʊd>
angst	<ɑŋkst>
slick	<slɪk>
wits	<wɪts>
paid	<peɪd>
airs	<ɛrz>
wince	<wɪns>
bret	<brɛt>
passed	<pæst>
lynch	<lɪnʧ>
mosque	<mɔsk>
haugh	<hɔ>
framed	<freɪmd>
aunt	<ɔnt>
wo	<woʊ>
darts	<dɑrts>
pope	<poʊp>
booze	<buz>
paque	<pæk>
shed	<ʃɛd>
jacks	<ʤæks>
aisle	<aɪəl>
cease	<sis>
mulch	<məlʧ>
pawn	<pɔn>
corp	<ˈkɔrpərˈeɪʃən>
marked	<mɑrkt>
stored	<stɔrd>
butt	<bət>
dost	<dɑst>
daft	<dæft>
odds	<ɑdz>
crib	<krɪb>
caps	<kæps>
tongue	<təŋ>
sink	<sɪŋk>
sein	<saɪn>
male	<meɪl>
gleam	<glim>
fraught	<frɔt>
breth	<brɛθ>
rusk	<rəsk>
swirl	<swərl>
kat	<kæt>
smog	<smɑg>
axe	<æks>
lipped	<lɪpt>
fest	<fɛst>
duff	<dəf>
heel	<hil>
wreak	<rik>
rase	<reɪz>
tails	<teɪlz>
spade	<speɪd>
thigh	<θaɪ>
zinc	<zɪŋk>
jive	<ʤaɪv>
hoot	<hut>
rind	<raɪnd>
fate	<feɪt>
vince	<vɪns>
matched	<mæʧt>
huck	<hək>
clift	<klɪft>
sprout	<spraʊt>
bored	<bɔrd>
stripe	<straɪp>
tuned	<tund>
froze	<froʊz>
realm	<rɛlm>
swam	<swæm>
spans	<spænz>
glue	<glu>
stitch	<stɪʧ>
tux	<təks>
reign	<reɪn>
tongued	<təŋd>
brant	<brænt>
same	<seɪm>
swoop	<swup>
strong	<strɔŋ>
quill	<kwɪl>
whale	<weɪl>
pooch	<puʧ>
paced	<peɪst>
munk	<məŋk>
foe	<foʊ>
staph	<stæf>
balm	<bɑm>
spake	<speɪk>
hyde	<haɪd>
gill	<gɪl>
sib	<sɪb>
dot	<dɑt>
preach	<priʧ>
pique	<pik>
tease	<tiz>
niece	<nis>
blimp	<blɪmp>
sack	<sæk>
graze	<greɪz>
mare	<mɛr>
bloke	<bloʊk>
domed	<doʊmd>
striped	<straɪpt>
scaled	<skeɪld>
snooze	<snuz>
ruck	<rək>
shay	<ʃeɪ>
barre	<ˈbɛri>
gents	<ʤɛnts>
boe	<boʊ>
reed	<rid>
that	<ðət>
capped	<kæpt>
chord	<kɔrd>
much	<məʧ>
crete	<krit>
vim	<vɪm>
priced	<praɪst>
fluke	<fluk>
tyrant	<ˈtaɪrənt>
quay	<ki>
trig	<trɪg>
rife	<raɪf>
vein	<veɪn>
calves	<kævz>
fide	<faɪd>
marc	<mɑrk>
stuck	<stək>
spouse	<spaʊs>
kis	<kɪs>
yuk	<jək>
banc	<bæŋk>
cheers	<ʧɪrz>
psyche	<ˈsaɪki>
cleft	<klɛft>
tally	<ˈtæli>
rhythm	<ˈrɪðəm>
rune	<run>
plague	<pleɪg>
mesh	<mɛʃ>
raff	<ræf>
birr	<bər>
bliss	<blɪs>
quel	<kwɛl>
cain	<keɪn>
mau	<moʊ>
voir	<vwɑr>
rall	<rɔl>
arms	<ɑrmz>
tweet	<twit>
jua	<ʤuə>
means	<minz>
nay	<neɪ>
cramped	<kræmpt>
eased	<izd>
cleat	<klit>
rolled	<roʊld>
cps	<ˈsiˌpiˈɛs>
alfa	<ˈælfə>
ringed	<rɪŋd>
racks	<ræks>
mink	<mɪŋk>
womb	<wum>
cape	<keɪp>
rong	<rɔŋ>
shah	<ʃɑ>
larch	<lɑrʧ>
lights	<laɪts>
fringe	<frɪnʤ>
paled	<peɪld>
taught	<tɔt>
pairs	<pɛrz>
nurse	<nərs>
stump	<stəmp>
malt	<mɔlt>
glance	<glæns>
strays	<streɪz>
grub	<grəb>
flush	<fləʃ>
bene	<ˈbɛnə>
iced	<aɪst>
yip	<jɪp>
puls	<pʊlz>
waltz	<wɔlts>
grilled	<grɪld>
smash	<smæʃ>
newt	<nut>
mien	<min>
flawed	<flɔd>
spoiled	<spɔɪld>
pimp	<pɪmp>
bronze	<brɑnz>
stern	<stərn>
waves	<weɪvz>
torn	<tɔrn>
tall	<tɔl>
yell	<jɛl>
plunge	<plənʤ>
stet	<stɛt>
keel	<kil>
lars	<lɑrz>
job	<ʤɑb>
bused	<bəst>
kit	<kɪt>
joss	<ʤɔs>
terse	<tərs>
kneel	<nil>
croup	<krup>
brash	<bræʃ>
mob	<mɑb>
teens	<tinz>
liked	<laɪkt>
clone	<kloʊn>
aw	<ɔ>
hives	<haɪvz>
beg	<bɛg>
nonce	<nɑns>
fax	<fæks>
egg	<ɛg>
beast	<bist>
cusp	<kəsp>
nuts	<nəts>
food	<fud>
tae	<teɪ>
cros	<krɔs>
bake	<beɪk>
hint	<hɪnt>
scarf	<skɑrf>
fume	<fjum>
haste	<heɪst>
moan	<moʊn>
guy	<gaɪ>
decks	<dɛks>
strick	<strɪk>
crab	<kræb>
bloc	<blɑk>
aid	<eɪd>
yet	<jɛt>
sloth	<sloʊθ>
rats	<ræts>
mousse	<mus>
bounce	<baʊns>
aug	<ˈɔgəst>
burke	<bərk>
forge	<fɔrʤ>
wich	<wɪʧ>
ange	<eɪnʤ>
tops	<tɑps>
gnat	<næt>
sticks	<stɪks>
lons	<lɑnz>
swine	<swaɪn>
plea	<pli>
spruce	<sprus>
raz	<ræz>
ids	<ˈaɪˈdiz>
nur	<nʊr>
shone	<ʃoʊn>
doe	<doʊ>
shark	<ʃɑrk>
scorn	<skɔrn>
smart	<smɑrt>
liang	<ljæŋ>
flame	<fleɪm>
passe	<ˌpæˈseɪ>
chaise	<ʃeɪz>
therm	<θərm>
pute	<pjut>
kcal	<ˈkeɪkɑl>
prune	<prun>
gau	<goʊ>
pills	<pɪlz>
links	<lɪŋks>
gild	<gɪld>
snuck	<snək>
poised	<pɔɪzd>
hills	<hɪlz>
cort	<kɔrt>
bait	<beɪt>
shrug	<ʃrəg>
grits	<grɪts>
yolk	<joʊk>
eared	<ɪrd>
paw	<pɔ>
wight	<waɪt>
cirque	<sərk>
fudge	<fəʤ>
soul	<soʊl>
dise	<daɪz>
frown	<fraʊn>
yank	<jæŋk>
vik	<vɪk>
speer	<spɪr>
giles	<ʤaɪlz>
bowls	<boʊlz>
crouse	<kraʊs>
weigh	<weɪ>
heap	<hip>
pill	<pɪl>
flue	<flu>
dwelt	<dwɛlt>
jane	<ʤeɪn>
kwan	<kwɑn>
zee	<zi>
franc	<fræŋk>
mug	<məg>
grom	<grɑm>
cramp	<kræmp>
cracked	<krækt>
badge	<bæʤ>
plains	<pleɪnz>
spate	<speɪt>
glazed	<gleɪzd>
doll	<dɑl>
celled	<sɛld>
trow	<troʊ>
lashed	<læʃt>
choir	<kwaɪər>
salm	<sɑm>
teed	<tid>
duo	<ˈduoʊ>
lewd	<lud>
midge	<mɪʤ>
dike	<daɪk>
twelfth	<twɛlfθ>
thwart	<θwɔrt>
shelled	<ʃɛld>
leal	<lil>
blond	<blɑnd>
bight	<baɪt>
jee	<ʤi>
launch	<lɔnʧ>
prow	<praʊ>
auth	<ɔθ>
wedge	<wɛʤ>
backed	<bækt>
smile	<smaɪl>
greaves	<grivz>
sixth	<sɪksθ>
flies	<flaɪz>
skiff	<skɪf>
worms	<wərmz>
rope	<roʊp>
staunch	<stɔnʧ>
swoosh	<swuʃ>
wharf	<wɔrf>
scourge	<skərʤ>
stig	<stɪg>
raise	<reɪz>
lise	<laɪz>
trice	<traɪs>
seer	<sir>
blinks	<blɪŋks>
probe	<proʊb>
loss	<lɔs>
trine	<traɪn>
blight	<blaɪt>
toss	<tɔs>
drone	<droʊn>
eyes	<aɪz>
breach	<briʧ>
imp	<ɪmp>
kang	<kɑŋ>
kemp	<kɛmp>
porch	<pɔrʧ>
pail	<peɪl>
fleece	<flis>
strive	<straɪv>
voiced	<vɔɪst>
nook	<nʊk>
rung	<rəŋ>
ewe	<ju>
endemic	<ɛnˈdɛmɪk>
grange	<greɪnʤ>
refer	<rɪˈfər>
sprawl	<sprɔl>
gyn	<gɪn>
coarse	<kɔrs>
ince	<ɪns>
dryer	<draɪər>
yarn	<jɑrn>
blues	<bluz>
whoops	<wups>
ranch	<rænʧ>
schoon	<skun>
crock	<krɑk>
prime	<praɪm>
fez	<fɛz>
foul	<faʊl>
tian	<tjɑn>
j	<ʤeɪ>
tailed	<teɪld>
slush	<sləʃ>
vie	<vaɪ>
drab	<dræb>
mince	<mɪns>
whoa	<woʊ>
cleanse	<klɛnz>
was	<wɑz>
shawl	<ʃɔl>
creep	<krip>
sync	<sɪŋk>
etc	<ˌɛtˈsɛtərə>
knelt	<nɛlt>
shale	<ʃeɪl>
gay	<geɪ>
month	<mənθ>
lox	<ləks>
stalled	<stɔld>
lodged	<lɑʤd>
groan	<groʊn>
gulp	<gəlp>
doom	<dum>
share	<ʃɛr>
filed	<faɪld>
mph	<ˈɛmˈpiˈeɪʧ>
snell	<snɛl>
raj	<rɑʤ>
warmth	<wɔrmθ>
shrimp	<ʃrɪmp>
sept	<sɛpt>
oct	<ɔkt>
bridge	<brɪʤ>
soak	<soʊk>
mech	<mɛk>
hutch	<həʧ>
holm	<hoʊm>
emu	<ˈimˌju>
thyme	<θaɪm>
hit	<hɪt>
gare	<gɛr>
sneeze	<sniz>
yule	<jul>
wolves	<wʊlvz>
rank	<ræŋk>
teal	<til>
bonne	<bɑn>
rift	<rɪft>
pale	<peɪl>
sprung	<sprəŋ>
mole	<moʊl>
beer	<bɪr>
versed	<vərst>
leaves	<livz>
cron	<krɑn>
coot	<kut>
ghoul	<gul>
mone	<moʊn>
stash	<stæʃ>
marsh	<mɑrʃ>
kiln	<kɪln>
grapes	<greɪps>
fouls	<faʊlz>
loe	<loʊ>
tung	<təŋ>
shalt	<ʃælt>
ninth	<naɪnθ>
dang	<dæŋ>
oath	<oʊθ>
willed	<wɪld>
samp	<sæmp>
berge	<bərʤ>
touche	<ˈtuˌʃeɪ>
thud	<θəd>
cell	<sɛl>
zed	<zɛd>
stalk	<stɔk>
roux	<ru>
caught	<kɔt>
hoe	<hoʊ>
kale	<keɪl>
mav	<mɑv>
brie	<bri>
slang	<slæŋ>
slant	<slænt>
crowd	<kraʊd>
batt	<bæt>
comm	<kɑm>
chen	<ʧɛn>
gush	<gəʃ>
paved	<peɪvd>
dealt	<dɛlt>
seep	<sip>
vore	<vɔr>
charles	<ˈʧɑrəlz>
flaps	<flæps>
bled	<blɛd>
bast	<bæst>
slump	<sləmp>
fane	<feɪn>
pele	<ˈpɛleɪ>
drought	<draʊt>
assed	<æst>
sealed	<sild>
dredge	<drɛʤ>
shank	<ʃæŋk>
gown	<gaʊn>
tory	<ˈtɔri>
licht	<lɪkt>
if	<ɪf>
hajj	<hæʤ>
mok	<mɑk>
halves	<hævz>
kal	<kæl>
needs	<nidz>
racial	<ˈreɪʃəl>
wow	<waʊ>
seize	<siz>
aide	<eɪd>
smear	<smɪr>
brine	<braɪn>
warp	<wɔrp>
torch	<tɔrʧ>
tears	<tɪrz>
chef	<ʃɛf>
dates	<deɪts>
pye	<paɪ>
shove	<ʃəv>
built	<bɪlt>
chad	<ʧæd>
quench	<kwɛnʧ>
rains	<reɪnz>
waved	<weɪvd>
seng	<sɛŋ>
buse	<bjuz>
blas	<blɑs>
schism	<ˈskɪzəm>
lymph	<lɪmf>
pipes	<paɪps>
strand	<strænd>
fag	<fæg>
burp	<bərp>
kris	<krɪs>
queue	<kju>
gosh	<gɑʃ>
dud	<dəd>
strait	<streɪt>
babe	<beɪb>
rue	<ru>
bane	<beɪn>
vous	<vu>
tusk	<təsk>
trained	<treɪnd>
tale	<teɪl>
claw	<klɔ>
shap	<ʃæp>
phones	<foʊnz>
noes	<noʊz>
barbed	<bɑrbd>
glint	<glɪnt>
fier	<fɪr>
griff	<grɪf>
lint	<lɪnt>
wreath	<riθ>
sarge	<sɑrʤ>
pushed	<pʊʃt>
spud	<spəd>
nave	<neɪv>
shag	<ʃæg>
suite	<swit>
swede	<swid>
thru	<θru>
wheeled	<wild>
dive	<daɪv>
mace	<meɪs>
loup	<lup>
thee	<ði>
shaved	<ʃeɪvd>
spleen	<splin>
conch	<kɑŋk>
plugged	<pləgd>
fleck	<flɛk>
quell	<kwɛl>
fant	<fænt>
lisk	<lɪsk>
stealth	<stɛlθ>
kite	<kaɪt>
moo	<mu>
turf	<tərf>
peaked	<pikt>
funds	<fəndz>
veiled	<veɪld>
prank	<præŋk>
sets	<sɛts>
delve	<dɛlv>
crypt	<krɪpt>
snub	<snəb>
crept	<krɛpt>
thorp	<θɔrp>
notch	<nɑʧ>
straw	<strɔ>
soothe	<suð>
bok	<bɑk>
jaw	<ʤɔ>
please	<pliz>
vette	<vɛt>
fuge	<fjuʤ>
gout	<gaʊt>
muff	<məf>
trades	<treɪdz>
poop	<pup>
kitsch	<kɪʧ>
hers	<hərz>
armed	<ɑrmd>
stave	<steɪv>
dorr	<dɔr>
crepe	<kreɪp>
fitch	<fɪʧ>
heh	<hɛ>
cover	<ˈkəvər>
broke	<broʊk>
joice	<ʤɔɪs>
tonne	<tən>
earned	<ərnd>
stark	<stɑrk>
keyed	<kid>
crabs	<kræbz>
tope	<toʊp>
bribe	<braɪb>
twig	<twɪg>
swath	<swɑθ>
spore	<spɔr>
cues	<kjuz>
snag	<snæg>
clothes	<kloʊðz>
chose	<ʧoʊz>
dues	<duz>
pelt	<pɛlt>
fork	<fɔrk>
dith	<dɪθ>
bitch	<bɪʧ>
app	<æp>
hours	<aʊərz>
brooch	<bruʧ>
staged	<steɪʤd>
near	<nɪr>
brushed	<brəʃt>
bream	<brim>
merle	<mərl>
toy	<tɔɪ>
luge	<luʤ>
roi	<rɔɪ>
jill	<ʤɪl>
fries	<fraɪz>
nored	<nɔrd>
sloop	<slup>
hors	<ɔr>
moe	<moʊ>
kern	<kərn>
disk	<dɪsk>
strike	<straɪk>
inter	<ˌɪnˈtər>
stores	<stɔrz>
cleave	<kliv>
chum	<ʧəm>
pulp	<pəlp>
wrought	<rɔt>
must	<məst>
peak	<pik>
chops	<ʧɑps>
crumb	<krəm>
edit	<ˈɛdət>
wench	<wɛnʧ>
dunk	<dəŋk>
ross	<rɔs>
scum	<skəm>
brecht	<brɛkt>
shelves	<ʃɛlvz>
smirk	<smərk>
err	<ɛr>
kim	<kɪm>
tong	<tɔŋ>
prone	<proʊn>
nah	<nɑ>
rote	<roʊt>
glib	<glɪb>
douche	<duʃ>
bram	<bræm>
deuce	<dus>
hail	<heɪl>
neis	<niz>
monk	<məŋk>
sri	<ˈɛˈsɑˈraɪ>
bice	<baɪs>
crux	<krəks>
kain	<keɪn>
loads	<loʊdz>
bick	<bɪk>
frigid	<ˈfrɪʤəd>
cush	<kʊʃ>
org	<ɔrg>
auld	<ɔld>
guin	<gɪn>
spent	<spɛnt>
pout	<paʊt>
geek	<gik>
kish	<kɪʃ>
zap	<zæp>
strife	<straɪf>
puck	<pək>
grine	<graɪn>
chock	<ʧɑk>
swatch	<swɑʧ>
mailed	<meɪld>
purse	<pərs>
spie	<spi>
sparks	<spɑrks>
rye	<raɪ>
spoils	<spɔɪlz>
ours	<ɑrz>
plough	<ploʊ>
lomb	<lɑm>
hoar	<hɔr>
plaque	<plæk>
flair	<flɛr>
trough	<trɔf>
chimp	<ʧɪmp>
broom	<brum>
wye	<waɪ>
gauss	<gaʊs>
pote	<poʊt>
bah	<bɑ>
alias	<ˈeɪliəs>
twang	<twɑŋ>
eighth	<eɪθ>
lathe	<leɪð>
fourth	<fɔrθ>
ouch	<aʊʧ>
scud	<skəd>
faced	<feɪst>
dwarf	<dwɔrf>
shrub	<ʃrəb>
crust	<krəst>
craze	<kreɪz>
thresh	<θrɛʃ>
sludge	<sləʤ>
hush	<həʃ>
rpm	<ˈɑrˈpiˈɛm>
braz	<bræz>
isle	<aɪl>
heald	<hild>
forked	<fɔrkt>
splint	<splɪnt>
shook	<ʃʊk>
breathe	<brið>
mice	<maɪs>
choy	<ʧɔɪ>
grime	<graɪm>
pai	<pɑi>
hath	<hæθ>
jakes	<ʤeɪks>
chives	<ʧaɪvz>
holt	<hoʊlt>
lawn	<lɔn>
stroud	<straʊd>
fledged	<flɛʤd>
poof	<puf>
ebb	<ɛb>
wry	<raɪ>
kelp	<kɛlp>
weave	<wiv>
moose	<mus>
f	<ɛf>
truce	<trus>
quote	<kwoʊt>
pray	<preɪ>
shard	<ʃɑrd>
mah	<mɑ>
jong	<ʤɔŋ>
leach	<liʧ>
lien	<lin>
paz	<pɑz>
poe	<poʊ>
delft	<dɛlft>
josh	<ʤɑʃ>
dukes	<duks>
edged	<ɛʤd>
bathe	<beɪð>
flute	<flut>
dressed	<drɛst>
strode	<stroʊd>
pere	<pər>
speck	<spɛk>
floats	<floʊts>
whig	<wɪg>
glaze	<gleɪz>
kroon	<krun>
jade	<ʤeɪd>
chee	<ʧi>
chore	<ʧɔr>
fawn	<fɔn>
prose	<proʊz>
bray	<breɪ>
dob	<dɑb>
choose	<ʧuz>
laun	<lɔn>
beet	<bit>
daze	<deɪz>
clout	<klaʊt>
macke	<mæk>
ident	<aɪˈdɛnt>
wont	<woʊnt>
kip	<kɪp>
wine	<waɪn>
blob	<blɑb>
clasp	<klæsp>
jae	<ʤeɪ>
clung	<kləŋ>
prelim	<prɪˈlɪm>
pouch	<paʊʧ>
growl	<graʊl>
vexed	<vɛkst>
chess	<ʧɛs>
cinch	<sɪnʧ>
leth	<lɛθ>
stein	<staɪn>
heave	<hiv>
poul	<pul>
stemmed	<stɛmd>
hoke	<hoʊk>
nik	<nɪk>
globe	<gloʊb>
reis	<riz>
pets	<pɛts>
stile	<staɪl>
gills	<gɪlz>
caulk	<kɔk>
those	<ðoʊz>
crotch	<krɑʧ>
sown	<soʊn>
pride	<praɪd>
slew	<slu>
glove	<gləv>
dak	<ˈdiˈeɪˈkeɪ>
thief	<θif>
creek	<krik>
geck	<ʤɛk>
oops	<ups>
loaves	<loʊvz>
tuft	<təft>
skit	<skɪt>
knives	<naɪvz>
flint	<flɪnt>
torr	<tɔr>
leek	<lik>
mart	<mɑrt>
tay	<teɪ>
skull	<skəl>
foil	<fɔɪl>
gad	<gæd>
foam	<foʊm>
roads	<roʊdz>
taunt	<tɔnt>
burk	<bərk>
gains	<geɪnz>
glut	<glət>
ell	<ɛl>
ounce	<aʊns>
sleigh	<sleɪ>
zipped	<zɪpt>
threw	<θru>
yeah	<jæ>
sheaf	<ʃif>
heid	<haɪd>
feast	<fist>
